"site","sanitation.fellingA","sanitation.fellingB","nhost","ncut1","ncut2","nadj","nnlp","ndam"
"site A",0,0,43,0,0,7,36,7
"site A",0,0,47,0,0,12,35,12
"site A",0,0,44,0,0,7,37,7
"site A",0,0,55,0,0,18,37,18
"site A",0,0,40,0,0,6,34,6
"site A",0,0,40,0,0,3,37,3
"site A",0,0,46,0,0,11,35,11
"site A",0,0,46,0,0,10,36,10
"site A",0,0,39,0,0,5,34,5
"site A",0,0,43,0,0,7,36,7
"site A",0,0,42,0,0,7,35,7
"site A",0,0,40,0,0,2,38,2
"site A",0,0,44,0,0,4,40,4
"site A",0,0,48,0,0,11,37,11
"site A",0,0,42,0,0,6,36,6
"site A",0,0,45,0,0,5,40,5
"site A",0,0,47,0,0,10,37,10
"site A",0,0,45,0,0,5,40,5
"site A",0,0,42,0,0,6,36,6
"site A",0,0,50,0,0,11,39,11
"site A",0,0,42,0,0,5,37,5
"site A",0,0,47,0,0,11,36,11
"site A",0,0,50,0,0,13,37,13
"site A",0,0,41,0,0,3,38,3
"site A",0,0,51,0,0,12,39,12
"site A",0,0,50,0,0,12,38,12
"site A",0,0,44,0,0,8,36,8
"site A",0,0,44,0,0,7,37,7
"site A",0,0,38,0,0,3,35,3
"site A",0,0,41,0,0,4,37,4
"site A",0,0,40,0,0,4,36,4
"site A",0,0,40,0,0,4,36,4
"site A",0,0,51,0,0,15,36,15
"site A",0,0,36,0,0,2,34,2
"site A",0,0,42,0,0,5,37,5
"site A",0,0,44,0,0,8,36,8
"site A",0,0,40,0,0,4,36,4
"site A",0,0,44,0,0,8,36,8
"site A",0,0,42,0,0,4,38,4
"site A",0,0,50,0,0,10,40,10
"site A",0,25,40,0,2,2,38,4
"site A",0,25,40,0,1,2,38,3
"site A",0,25,35,0,1,1,34,2
"site A",0,25,44,0,2,5,39,7
"site A",0,25,39,0,1,3,36,4
"site A",0,25,38,0,1,2,36,3
"site A",0,25,39,0,1,1,38,2
"site A",0,25,38,0,1,2,36,3
"site A",0,25,37,0,1,2,35,3
"site A",0,25,40,0,1,1,39,2
"site A",0,25,38,0,2,3,35,5
"site A",0,25,43,0,2,5,38,7
"site A",0,25,43,0,2,5,38,7
"site A",0,25,38,0,0,2,36,2
"site A",0,25,42,0,2,5,37,7
"site A",0,25,41,0,2,5,36,7
"site A",0,25,41,0,0,2,39,2
"site A",0,25,38,0,1,3,35,4
"site A",0,25,43,0,2,4,39,6
"site A",0,25,42,0,2,4,38,6
"site A",0,25,38,0,1,1,37,2
"site A",0,25,39,0,1,2,37,3
"site A",0,25,40,0,2,4,36,6
"site A",0,25,34,0,1,2,32,3
"site A",0,25,40,0,1,2,38,3
"site A",0,25,39,0,2,4,35,6
"site A",0,25,44,0,2,6,38,8
"site A",0,25,40,0,1,2,38,3
"site A",0,25,34,0,1,1,33,2
"site A",0,25,42,0,0,2,40,2
"site A",0,25,39,0,1,1,38,2
"site A",0,25,40,0,2,4,36,6
"site A",0,25,40,0,1,1,39,2
"site A",0,25,45,0,2,5,40,7
"site A",0,25,38,0,1,1,37,2
"site A",0,25,34,0,1,1,33,2
"site A",0,25,37,0,1,1,36,2
"site A",0,25,37,0,1,2,35,3
"site A",0,25,40,0,2,2,38,4
"site A",0,25,36,0,1,1,35,2
"site A",0,50,36,0,3,1,35,4
"site A",0,50,38,0,2,1,37,3
"site A",0,50,38,0,2,1,37,3
"site A",0,50,38,0,2,1,37,3
"site A",0,50,39,0,3,1,38,4
"site A",0,50,38,0,2,1,37,3
"site A",0,50,40,0,2,1,39,3
"site A",0,50,38,0,1,0,38,1
"site A",0,50,38,0,1,1,37,2
"site A",0,50,35,0,2,1,34,3
"site A",0,50,34,0,2,1,33,3
"site A",0,50,37,0,1,1,36,2
"site A",0,50,38,0,2,2,36,4
"site A",0,50,35,0,1,0,35,1
"site A",0,50,38,0,2,1,37,3
"site A",0,50,36,0,3,1,35,4
"site A",0,50,38,0,3,1,37,4
"site A",0,50,38,0,2,1,37,3
"site A",0,50,39,0,2,1,38,3
"site A",0,50,35,0,1,0,35,1
"site A",0,50,34,0,1,0,34,1
"site A",0,50,34,0,2,1,33,3
"site A",0,50,37,0,2,2,35,4
"site A",0,50,37,0,3,1,36,4
"site A",0,50,40,0,2,1,39,3
"site A",0,50,37,0,1,0,37,1
"site A",0,50,40,0,3,1,39,4
"site A",0,50,38,0,2,1,37,3
"site A",0,50,36,0,1,0,36,1
"site A",0,50,38,0,2,1,37,3
"site A",0,50,35,0,1,1,34,2
"site A",0,50,37,0,1,1,36,2
"site A",0,50,40,0,2,1,39,3
"site A",0,50,35,0,3,1,34,4
"site A",0,50,37,0,3,1,36,4
"site A",0,50,38,0,3,1,37,4
"site A",0,50,37,0,2,1,36,3
"site A",0,50,39,0,2,1,38,3
"site A",0,50,37,0,1,0,37,1
"site A",0,50,38,0,1,1,37,2
"site A",0,75,38,0,4,1,37,5
"site A",0,75,34,0,2,0,34,2
"site A",0,75,35,0,4,1,34,5
"site A",0,75,37,0,2,0,37,2
"site A",0,75,36,0,3,1,35,4
"site A",0,75,36,0,3,1,35,4
"site A",0,75,37,0,2,0,37,2
"site A",0,75,40,0,4,1,39,5
"site A",0,75,36,0,1,0,36,1
"site A",0,75,36,0,3,1,35,4
"site A",0,75,37,0,2,0,37,2
"site A",0,75,36,0,2,0,36,2
"site A",0,75,38,0,3,1,37,4
"site A",0,75,37,0,2,0,37,2
"site A",0,75,36,0,2,0,36,2
"site A",0,75,40,0,2,1,39,3
"site A",0,75,37,0,2,0,37,2
"site A",0,75,36,0,2,0,36,2
"site A",0,75,37,0,2,0,37,2
"site A",0,75,36,0,2,0,36,2
"site A",0,75,37,0,3,1,36,4
"site A",0,75,37,0,2,0,37,2
"site A",0,75,36,0,3,1,35,4
"site A",0,75,39,0,2,0,39,2
"site A",0,75,38,0,2,0,38,2
"site A",0,75,39,0,1,0,39,1
"site A",0,75,39,0,3,1,38,4
"site A",0,75,37,0,2,0,37,2
"site A",0,75,35,0,2,0,35,2
"site A",0,75,36,0,2,0,36,2
"site A",0,75,37,0,3,1,36,4
"site A",0,75,38,0,2,1,37,3
"site A",0,75,39,0,1,0,39,1
"site A",0,75,32,0,2,1,31,3
"site A",0,75,39,0,2,0,39,2
"site A",0,75,37,0,2,0,37,2
"site A",0,75,38,0,2,0,38,2
"site A",0,75,38,0,3,1,37,4
"site A",0,75,38,0,3,1,37,4
"site A",0,75,37,0,2,0,37,2
"site A",0,100,41,0,2,0,41,2
"site A",0,100,40,0,2,0,40,2
"site A",0,100,38,0,2,0,38,2
"site A",0,100,37,0,1,0,37,1
"site A",0,100,37,0,3,0,37,3
"site A",0,100,36,0,2,0,36,2
"site A",0,100,38,0,2,0,38,2
"site A",0,100,37,0,3,0,37,3
"site A",0,100,34,0,3,0,34,3
"site A",0,100,36,0,2,0,36,2
"site A",0,100,39,0,2,0,39,2
"site A",0,100,35,0,2,0,35,2
"site A",0,100,32,0,3,0,32,3
"site A",0,100,34,0,3,0,34,3
"site A",0,100,39,0,3,0,39,3
"site A",0,100,36,0,2,0,36,2
"site A",0,100,41,0,2,0,41,2
"site A",0,100,35,0,2,0,35,2
"site A",0,100,39,0,3,0,39,3
"site A",0,100,37,0,2,0,37,2
"site A",0,100,38,0,2,0,38,2
"site A",0,100,35,0,2,0,35,2
"site A",0,100,37,0,2,0,37,2
"site A",0,100,33,0,2,0,33,2
"site A",0,100,34,0,2,0,34,2
"site A",0,100,37,0,1,0,37,1
"site A",0,100,36,0,3,0,36,3
"site A",0,100,39,0,2,0,39,2
"site A",0,100,34,0,3,0,34,3
"site A",0,100,35,0,3,0,35,3
"site A",0,100,36,0,3,0,36,3
"site A",0,100,36,0,1,0,36,1
"site A",0,100,39,0,3,0,39,3
"site A",0,100,41,0,3,0,41,3
"site A",0,100,36,0,3,0,36,3
"site A",0,100,36,0,3,0,36,3
"site A",0,100,35,0,2,0,35,2
"site A",0,100,34,0,2,0,34,2
"site A",0,100,35,0,2,0,35,2
"site A",0,100,34,0,1,0,34,1
"site A",25,0,31,9,0,7,24,7
"site A",25,0,31,8,0,9,22,9
"site A",25,0,29,9,0,4,25,4
"site A",25,0,31,9,0,7,24,7
"site A",25,0,27,8,0,3,24,3
"site A",25,0,29,8,0,4,25,4
"site A",25,0,31,9,0,7,24,7
"site A",25,0,24,7,0,3,21,3
"site A",25,0,32,9,0,9,23,9
"site A",25,0,31,9,0,6,25,6
"site A",25,0,28,9,0,3,25,3
"site A",25,0,27,8,0,3,24,3
"site A",25,0,31,9,0,7,24,7
"site A",25,0,26,8,0,3,23,3
"site A",25,0,27,8,0,3,24,3
"site A",25,0,29,8,0,6,23,6
"site A",25,0,29,8,0,6,23,6
"site A",25,0,32,9,0,9,23,9
"site A",25,0,32,9,0,8,24,8
"site A",25,0,26,8,0,3,23,3
"site A",25,0,30,9,0,7,23,7
"site A",25,0,33,8,0,10,23,10
"site A",25,0,27,8,0,3,24,3
"site A",25,0,26,8,0,3,23,3
"site A",25,0,29,8,0,6,23,6
"site A",25,0,36,8,0,12,24,12
"site A",25,0,25,8,0,4,21,4
"site A",25,0,32,8,0,9,23,9
"site A",25,0,30,8,0,6,24,6
"site A",25,0,25,8,0,2,23,2
"site A",25,0,25,8,0,2,23,2
"site A",25,0,27,7,0,4,23,4
"site A",25,0,32,8,0,8,24,8
"site A",25,0,30,8,0,5,25,5
"site A",25,0,28,8,0,5,23,5
"site A",25,0,30,7,0,8,22,8
"site A",25,0,30,7,0,7,23,7
"site A",25,0,25,8,0,3,22,3
"site A",25,0,31,7,0,8,23,8
"site A",25,0,24,7,0,2,22,2
"site A",25,25,23,8,1,2,21,3
"site A",25,25,26,8,0,2,24,2
"site A",25,25,24,7,1,2,22,3
"site A",25,25,25,8,2,3,22,5
"site A",25,25,23,7,1,2,21,3
"site A",25,25,28,9,1,2,26,3
"site A",25,25,26,8,0,2,24,2
"site A",25,25,25,8,1,1,24,2
"site A",25,25,22,7,1,1,21,2
"site A",25,25,24,7,1,2,22,3
"site A",25,25,28,9,1,3,25,4
"site A",25,25,27,8,2,3,24,5
"site A",25,25,23,7,1,1,22,2
"site A",25,25,25,8,0,2,23,2
"site A",25,25,24,7,1,2,22,3
"site A",25,25,28,8,2,4,24,6
"site A",25,25,26,8,1,1,25,2
"site A",25,25,23,8,1,2,21,3
"site A",25,25,23,7,1,1,22,2
"site A",25,25,23,8,1,1,22,2
"site A",25,25,26,9,1,2,24,3
"site A",25,25,25,8,1,3,22,4
"site A",25,25,27,9,1,1,26,2
"site A",25,25,25,8,0,2,23,2
"site A",25,25,26,8,2,2,24,4
"site A",25,25,23,8,1,1,22,2
"site A",25,25,23,7,0,2,21,2
"site A",25,25,24,9,1,1,23,2
"site A",25,25,23,8,1,3,20,4
"site A",25,25,24,8,1,2,22,3
"site A",25,25,24,9,1,1,23,2
"site A",25,25,27,8,1,3,24,4
"site A",25,25,25,9,1,1,24,2
"site A",25,25,27,8,2,3,24,5
"site A",25,25,26,9,1,1,25,2
"site A",25,25,24,8,0,2,22,2
"site A",25,25,25,9,0,2,23,2
"site A",25,25,28,8,2,5,23,7
"site A",25,25,24,8,1,2,22,3
"site A",25,25,26,7,2,3,23,5
"site A",25,50,23,7,1,1,22,2
"site A",25,50,26,9,1,0,26,1
"site A",25,50,22,8,1,1,21,2
"site A",25,50,22,7,2,1,21,3
"site A",25,50,23,7,1,1,22,2
"site A",25,50,23,7,1,0,23,1
"site A",25,50,20,7,3,1,19,4
"site A",25,50,24,8,2,1,23,3
"site A",25,50,23,8,2,1,22,3
"site A",25,50,24,8,2,1,23,3
"site A",25,50,25,8,2,1,24,3
"site A",25,50,23,8,3,1,22,4
"site A",25,50,22,8,1,1,21,2
"site A",25,50,22,7,1,1,21,2
"site A",25,50,24,7,3,1,23,4
"site A",25,50,24,8,2,1,23,3
"site A",25,50,26,8,3,2,24,5
"site A",25,50,23,8,1,1,22,2
"site A",25,50,25,8,2,1,24,3
"site A",25,50,22,8,3,1,21,4
"site A",25,50,23,8,1,0,23,1
"site A",25,50,24,8,2,1,23,3
"site A",25,50,26,8,1,1,25,2
"site A",25,50,24,8,2,1,23,3
"site A",25,50,22,7,2,1,21,3
"site A",25,50,25,8,1,1,24,2
"site A",25,50,23,8,1,1,22,2
"site A",25,50,26,9,3,1,25,4
"site A",25,50,27,9,1,1,26,2
"site A",25,50,21,8,1,1,20,2
"site A",25,50,26,9,2,1,25,3
"site A",25,50,25,9,1,1,24,2
"site A",25,50,26,9,2,1,25,3
"site A",25,50,26,9,2,1,25,3
"site A",25,50,25,9,1,0,25,1
"site A",25,50,24,9,2,1,23,3
"site A",25,50,24,7,1,1,23,2
"site A",25,50,23,8,1,0,23,1
"site A",25,50,24,8,3,1,23,4
"site A",25,50,22,8,1,1,21,2
"site A",25,75,23,9,2,0,23,2
"site A",25,75,22,8,3,1,21,4
"site A",25,75,23,8,2,0,23,2
"site A",25,75,24,8,2,0,24,2
"site A",25,75,24,9,2,0,24,2
"site A",25,75,23,8,2,0,23,2
"site A",25,75,23,8,2,0,23,2
"site A",25,75,25,8,2,1,24,3
"site A",25,75,23,8,3,1,22,4
"site A",25,75,24,8,3,1,23,4
"site A",25,75,21,8,2,0,21,2
"site A",25,75,24,8,2,0,24,2
"site A",25,75,23,7,1,0,23,1
"site A",25,75,23,8,2,0,23,2
"site A",25,75,24,8,2,0,24,2
"site A",25,75,23,8,2,0,23,2
"site A",25,75,20,7,2,0,20,2
"site A",25,75,22,8,2,0,22,2
"site A",25,75,23,8,2,0,23,2
"site A",25,75,24,8,2,0,24,2
"site A",25,75,21,8,2,0,21,2
"site A",25,75,24,8,2,0,24,2
"site A",25,75,21,7,2,0,21,2
"site A",25,75,24,8,2,0,24,2
"site A",25,75,20,7,2,0,20,2
"site A",25,75,23,7,3,1,22,4
"site A",25,75,21,8,1,0,21,1
"site A",25,75,20,8,1,0,20,1
"site A",25,75,25,9,1,0,25,1
"site A",25,75,24,8,2,0,24,2
"site A",25,75,24,9,3,1,23,4
"site A",25,75,25,8,2,1,24,3
"site A",25,75,21,8,2,0,21,2
"site A",25,75,22,7,2,0,22,2
"site A",25,75,22,8,2,0,22,2
"site A",25,75,26,9,2,1,25,3
"site A",25,75,22,7,3,1,21,4
"site A",25,75,19,7,2,0,19,2
"site A",25,75,23,8,2,0,23,2
"site A",25,75,22,8,2,0,22,2
"site A",25,100,24,8,3,0,24,3
"site A",25,100,22,8,2,0,22,2
"site A",25,100,23,8,2,0,23,2
"site A",25,100,21,8,3,0,21,3
"site A",25,100,23,7,2,0,23,2
"site A",25,100,24,8,2,0,24,2
"site A",25,100,23,8,1,0,23,1
"site A",25,100,22,8,2,0,22,2
"site A",25,100,22,8,3,0,22,3
"site A",25,100,24,8,2,0,24,2
"site A",25,100,22,7,2,0,22,2
"site A",25,100,25,9,1,0,25,1
"site A",25,100,24,8,3,0,24,3
"site A",25,100,24,8,3,0,24,3
"site A",25,100,24,9,2,0,24,2
"site A",25,100,24,9,2,0,24,2
"site A",25,100,23,8,2,0,23,2
"site A",25,100,23,9,1,0,23,1
"site A",25,100,22,8,2,0,22,2
"site A",25,100,22,8,2,0,22,2
"site A",25,100,25,9,2,0,25,2
"site A",25,100,23,8,2,0,23,2
"site A",25,100,24,8,3,0,24,3
"site A",25,100,23,8,3,0,23,3
"site A",25,100,23,8,2,0,23,2
"site A",25,100,22,8,3,0,22,3
"site A",25,100,23,8,3,0,23,3
"site A",25,100,23,7,3,0,23,3
"site A",25,100,21,8,1,0,21,1
"site A",25,100,24,9,3,0,24,3
"site A",25,100,23,9,2,0,23,2
"site A",25,100,24,9,3,0,24,3
"site A",25,100,22,8,2,0,22,2
"site A",25,100,23,8,3,0,23,3
"site A",25,100,24,8,3,0,24,3
"site A",25,100,24,8,2,0,24,2
"site A",25,100,23,8,2,0,23,2
"site A",25,100,22,7,2,0,22,2
"site A",25,100,24,9,3,0,24,3
"site A",25,100,23,8,2,0,23,2
"site A",50,0,16,14,0,3,13,3
"site A",50,0,16,14,0,3,13,3
"site A",50,0,16,14,0,2,14,2
"site A",50,0,21,15,0,8,13,8
"site A",50,0,21,15,0,7,14,7
"site A",50,0,14,14,0,1,13,1
"site A",50,0,19,14,0,6,13,6
"site A",50,0,21,16,0,6,15,6
"site A",50,0,21,14,0,8,13,8
"site A",50,0,18,15,0,4,14,4
"site A",50,0,15,14,0,2,13,2
"site A",50,0,17,15,0,4,13,4
"site A",50,0,16,13,0,4,12,4
"site A",50,0,18,13,0,6,12,6
"site A",50,0,14,12,0,3,11,3
"site A",50,0,15,14,0,2,13,2
"site A",50,0,17,14,0,4,13,4
"site A",50,0,17,14,0,4,13,4
"site A",50,0,16,15,0,3,13,3
"site A",50,0,15,15,0,2,13,2
"site A",50,0,16,16,0,2,14,2
"site A",50,0,21,14,0,7,14,7
"site A",50,0,21,14,0,8,13,8
"site A",50,0,16,14,0,2,14,2
"site A",50,0,17,14,0,4,13,4
"site A",50,0,16,15,0,3,13,3
"site A",50,0,19,14,0,6,13,6
"site A",50,0,15,12,0,4,11,4
"site A",50,0,21,15,0,7,14,7
"site A",50,0,21,15,0,7,14,7
"site A",50,0,16,15,0,2,14,2
"site A",50,0,19,15,0,6,13,6
"site A",50,0,16,14,0,2,14,2
"site A",50,0,17,16,0,3,14,3
"site A",50,0,19,14,0,6,13,6
"site A",50,0,22,15,0,8,14,8
"site A",50,0,15,14,0,3,12,3
"site A",50,0,16,13,0,4,12,4
"site A",50,0,16,14,0,2,14,2
"site A",50,0,15,13,0,3,12,3
"site A",50,25,16,16,0,2,14,2
"site A",50,25,16,16,1,2,14,3
"site A",50,25,16,14,1,2,14,3
"site A",50,25,16,15,1,2,14,3
"site A",50,25,15,14,1,1,14,2
"site A",50,25,18,14,2,4,14,6
"site A",50,25,16,14,2,3,13,5
"site A",50,25,14,14,1,1,13,2
"site A",50,25,14,14,1,1,13,2
"site A",50,25,15,15,1,1,14,2
"site A",50,25,14,14,1,2,12,3
"site A",50,25,15,15,1,1,14,2
"site A",50,25,15,14,1,2,13,3
"site A",50,25,15,15,1,1,14,2
"site A",50,25,16,15,2,3,13,5
"site A",50,25,15,14,1,1,14,2
"site A",50,25,14,13,1,2,12,3
"site A",50,25,14,15,1,1,13,2
"site A",50,25,18,16,1,3,15,4
"site A",50,25,17,16,0,2,15,2
"site A",50,25,18,16,1,3,15,4
"site A",50,25,18,15,2,4,14,6
"site A",50,25,17,15,0,2,15,2
"site A",50,25,15,15,1,1,14,2
"site A",50,25,16,14,1,3,13,4
"site A",50,25,14,13,1,1,13,2
"site A",50,25,15,14,0,1,14,1
"site A",50,25,15,14,1,1,14,2
"site A",50,25,17,14,2,3,14,5
"site A",50,25,14,15,1,1,13,2
"site A",50,25,16,16,0,2,14,2
"site A",50,25,15,13,1,2,13,3
"site A",50,25,15,15,1,2,13,3
"site A",50,25,17,14,1,3,14,4
"site A",50,25,16,15,1,2,14,3
"site A",50,25,16,15,1,1,15,2
"site A",50,25,17,14,1,3,14,4
"site A",50,25,16,15,1,2,14,3
"site A",50,25,18,14,2,4,14,6
"site A",50,25,15,14,1,2,13,3
"site A",50,50,13,14,1,1,12,2
"site A",50,50,14,14,3,1,13,4
"site A",50,50,13,13,3,1,12,4
"site A",50,50,15,15,1,0,15,1
"site A",50,50,15,14,2,1,14,3
"site A",50,50,15,14,1,1,14,2
"site A",50,50,14,13,2,1,13,3
"site A",50,50,15,16,2,1,14,3
"site A",50,50,15,16,3,1,14,4
"site A",50,50,14,15,3,1,13,4
"site A",50,50,14,14,1,1,13,2
"site A",50,50,13,14,1,1,12,2
"site A",50,50,15,14,1,1,14,2
"site A",50,50,14,14,3,1,13,4
"site A",50,50,15,15,2,1,14,3
"site A",50,50,15,14,3,1,14,4
"site A",50,50,16,16,2,1,15,3
"site A",50,50,15,15,1,0,15,1
"site A",50,50,15,15,3,1,14,4
"site A",50,50,13,12,1,1,12,2
"site A",50,50,15,15,3,1,14,4
"site A",50,50,15,14,2,1,14,3
"site A",50,50,14,14,3,1,13,4
"site A",50,50,13,14,1,0,13,1
"site A",50,50,13,14,2,1,12,3
"site A",50,50,14,15,2,1,13,3
"site A",50,50,13,15,1,0,13,1
"site A",50,50,15,15,2,1,14,3
"site A",50,50,15,15,2,1,14,3
"site A",50,50,13,13,3,1,12,4
"site A",50,50,12,14,1,0,12,1
"site A",50,50,14,14,1,1,13,2
"site A",50,50,15,14,1,1,14,2
"site A",50,50,14,14,3,1,13,4
"site A",50,50,13,13,2,1,12,3
"site A",50,50,15,15,2,1,14,3
"site A",50,50,16,15,1,1,15,2
"site A",50,50,13,13,2,1,12,3
"site A",50,50,14,14,3,1,13,4
"site A",50,50,14,16,1,0,14,1
"site A",50,75,13,15,2,0,13,2
"site A",50,75,14,14,3,1,13,4
"site A",50,75,15,15,3,1,14,4
"site A",50,75,14,14,3,1,13,4
"site A",50,75,16,15,3,1,15,4
"site A",50,75,13,13,2,0,13,2
"site A",50,75,15,15,2,1,14,3
"site A",50,75,14,15,2,0,14,2
"site A",50,75,13,14,2,0,13,2
"site A",50,75,13,14,2,0,13,2
"site A",50,75,15,15,3,1,14,4
"site A",50,75,14,14,2,0,14,2
"site A",50,75,14,14,2,0,14,2
"site A",50,75,15,14,3,1,14,4
"site A",50,75,15,15,3,1,14,4
"site A",50,75,16,15,2,1,15,3
"site A",50,75,13,14,2,0,13,2
"site A",50,75,13,14,2,0,13,2
"site A",50,75,15,15,2,1,14,3
"site A",50,75,13,13,2,1,12,3
"site A",50,75,14,14,3,1,13,4
"site A",50,75,14,14,2,1,13,3
"site A",50,75,12,13,2,0,12,2
"site A",50,75,13,15,2,0,13,2
"site A",50,75,13,14,2,0,13,2
"site A",50,75,13,14,1,0,13,1
"site A",50,75,14,15,2,0,14,2
"site A",50,75,14,14,2,1,13,3
"site A",50,75,14,15,3,1,13,4
"site A",50,75,13,15,2,0,13,2
"site A",50,75,15,15,3,1,14,4
"site A",50,75,13,15,2,0,13,2
"site A",50,75,15,15,3,1,14,4
"site A",50,75,15,14,2,1,14,3
"site A",50,75,13,14,1,0,13,1
"site A",50,75,14,15,2,0,14,2
"site A",50,75,14,14,2,0,14,2
"site A",50,75,14,14,1,0,14,1
"site A",50,75,14,15,2,0,14,2
"site A",50,75,14,14,1,0,14,1
"site A",50,100,15,15,1,0,15,1
"site A",50,100,13,15,1,0,13,1
"site A",50,100,14,16,2,0,14,2
"site A",50,100,13,14,2,0,13,2
"site A",50,100,13,15,2,0,13,2
"site A",50,100,13,14,2,0,13,2
"site A",50,100,13,14,2,0,13,2
"site A",50,100,13,15,3,0,13,3
"site A",50,100,13,14,2,0,13,2
"site A",50,100,12,13,3,0,12,3
"site A",50,100,14,15,3,0,14,3
"site A",50,100,13,13,1,0,13,1
"site A",50,100,13,13,2,0,13,2
"site A",50,100,13,14,1,0,13,1
"site A",50,100,14,15,2,0,14,2
"site A",50,100,13,14,2,0,13,2
"site A",50,100,12,13,2,0,12,2
"site A",50,100,13,15,2,0,13,2
"site A",50,100,13,15,2,0,13,2
"site A",50,100,13,15,1,0,13,1
"site A",50,100,14,15,2,0,14,2
"site A",50,100,13,15,1,0,13,1
"site A",50,100,13,13,2,0,13,2
"site A",50,100,13,14,2,0,13,2
"site A",50,100,14,14,2,0,14,2
"site A",50,100,13,14,2,0,13,2
"site A",50,100,12,13,2,0,12,2
"site A",50,100,13,15,2,0,13,2
"site A",50,100,13,14,1,0,13,1
"site A",50,100,14,15,2,0,14,2
"site A",50,100,12,13,3,0,12,3
"site A",50,100,14,15,3,0,14,3
"site A",50,100,13,14,3,0,13,3
"site A",50,100,13,14,2,0,13,2
"site A",50,100,14,14,3,0,14,3
"site A",50,100,14,14,2,0,14,2
"site A",50,100,14,15,2,0,14,2
"site A",50,100,13,14,2,0,13,2
"site A",50,100,14,15,2,0,14,2
"site A",50,100,14,15,2,0,14,2
"site A",75,0,8,19,0,2,6,2
"site A",75,0,11,20,0,5,6,5
"site A",75,0,8,19,0,2,6,2
"site A",75,0,8,20,0,2,6,2
"site A",75,0,11,20,0,5,6,5
"site A",75,0,13,20,0,6,7,6
"site A",75,0,10,20,0,3,7,3
"site A",75,0,8,20,0,2,6,2
"site A",75,0,14,20,0,7,7,7
"site A",75,0,12,20,0,6,6,6
"site A",75,0,8,20,0,2,6,2
"site A",75,0,8,18,0,2,6,2
"site A",75,0,7,20,0,1,6,1
"site A",75,0,8,20,0,2,6,2
"site A",75,0,14,20,0,7,7,7
"site A",75,0,9,20,0,2,7,2
"site A",75,0,10,20,0,3,7,3
"site A",75,0,9,20,0,3,6,3
"site A",75,0,8,20,0,2,6,2
"site A",75,0,8,19,0,2,6,2
"site A",75,0,7,20,0,1,6,1
"site A",75,0,13,19,0,7,6,7
"site A",75,0,12,20,0,6,6,6
"site A",75,0,9,20,0,2,7,2
"site A",75,0,9,21,0,2,7,2
"site A",75,0,11,19,0,5,6,5
"site A",75,0,8,20,0,1,7,1
"site A",75,0,7,19,0,1,6,1
"site A",75,0,7,20,0,1,6,1
"site A",75,0,9,20,0,2,7,2
"site A",75,0,12,20,0,6,6,6
"site A",75,0,9,20,0,2,7,2
"site A",75,0,8,20,0,2,6,2
"site A",75,0,8,20,0,1,7,1
"site A",75,0,12,19,0,6,6,6
"site A",75,0,12,20,0,6,6,6
"site A",75,0,10,21,0,3,7,3
"site A",75,0,9,20,0,2,7,2
"site A",75,0,8,20,0,2,6,2
"site A",75,0,8,20,0,2,6,2
"site A",75,25,7,20,1,1,6,2
"site A",75,25,8,20,1,2,6,3
"site A",75,25,7,20,1,1,6,2
"site A",75,25,7,19,1,1,6,2
"site A",75,25,9,19,1,3,6,4
"site A",75,25,7,20,0,1,6,1
"site A",75,25,7,18,1,1,6,2
"site A",75,25,9,20,1,3,6,4
"site A",75,25,9,20,2,3,6,5
"site A",75,25,7,20,0,1,6,1
"site A",75,25,10,20,2,3,7,5
"site A",75,25,9,20,1,2,7,3
"site A",75,25,8,20,1,2,6,3
"site A",75,25,7,20,0,1,6,1
"site A",75,25,8,21,1,1,7,2
"site A",75,25,8,21,1,1,7,2
"site A",75,25,10,20,1,3,7,4
"site A",75,25,7,20,1,1,6,2
"site A",75,25,10,20,1,3,7,4
"site A",75,25,7,20,1,1,6,2
"site A",75,25,8,20,1,1,7,2
"site A",75,25,7,20,1,1,6,2
"site A",75,25,8,20,1,1,7,2
"site A",75,25,7,19,0,1,6,1
"site A",75,25,7,19,1,1,6,2
"site A",75,25,10,20,2,3,7,5
"site A",75,25,8,21,0,1,7,1
"site A",75,25,8,20,1,1,7,2
"site A",75,25,8,20,0,1,7,1
"site A",75,25,9,20,1,3,6,4
"site A",75,25,7,19,1,1,6,2
"site A",75,25,10,20,1,3,7,4
"site A",75,25,11,21,2,4,7,6
"site A",75,25,7,19,1,1,6,2
"site A",75,25,8,20,1,1,7,2
"site A",75,25,7,20,1,1,6,2
"site A",75,25,8,21,1,2,6,3
"site A",75,25,7,20,1,1,6,2
"site A",75,25,8,20,1,1,7,2
"site A",75,25,8,20,1,2,6,3
"site A",75,50,7,19,1,1,6,2
"site A",75,50,8,20,2,1,7,3
"site A",75,50,8,21,1,1,7,2
"site A",75,50,7,19,1,1,6,2
"site A",75,50,7,19,1,1,6,2
"site A",75,50,7,21,1,1,6,2
"site A",75,50,8,20,1,1,7,2
"site A",75,50,8,20,2,1,7,3
"site A",75,50,8,20,1,1,7,2
"site A",75,50,6,19,1,0,6,1
"site A",75,50,7,19,1,1,6,2
"site A",75,50,7,19,2,1,6,3
"site A",75,50,6,20,1,0,6,1
"site A",75,50,6,19,1,0,6,1
"site A",75,50,7,20,1,1,6,2
"site A",75,50,7,19,1,1,6,2
"site A",75,50,8,21,1,1,7,2
"site A",75,50,7,21,1,1,6,2
"site A",75,50,8,20,1,1,7,2
"site A",75,50,8,20,3,1,7,4
"site A",75,50,8,20,2,1,7,3
"site A",75,50,8,21,1,1,7,2
"site A",75,50,8,20,1,1,7,2
"site A",75,50,7,20,2,1,6,3
"site A",75,50,8,20,2,1,7,3
"site A",75,50,7,20,1,1,6,2
"site A",75,50,7,20,2,1,6,3
"site A",75,50,7,19,1,1,6,2
"site A",75,50,7,20,1,1,6,2
"site A",75,50,8,20,1,1,7,2
"site A",75,50,7,19,2,1,6,3
"site A",75,50,7,20,2,1,6,3
"site A",75,50,8,21,1,1,7,2
"site A",75,50,8,21,1,1,7,2
"site A",75,50,7,20,2,1,6,3
"site A",75,50,7,20,3,1,6,4
"site A",75,50,7,20,3,1,6,4
"site A",75,50,8,20,1,1,7,2
"site A",75,50,7,19,1,1,6,2
"site A",75,50,7,20,1,1,6,2
"site A",75,75,7,20,2,0,7,2
"site A",75,75,8,20,2,1,7,3
"site A",75,75,7,20,1,0,7,1
"site A",75,75,6,19,2,0,6,2
"site A",75,75,8,21,3,1,7,4
"site A",75,75,7,20,2,0,7,2
"site A",75,75,7,19,2,1,6,3
"site A",75,75,7,20,2,0,7,2
"site A",75,75,7,20,2,0,7,2
"site A",75,75,6,20,2,0,6,2
"site A",75,75,7,20,2,0,7,2
"site A",75,75,6,20,2,0,6,2
"site A",75,75,8,21,3,1,7,4
"site A",75,75,6,19,2,0,6,2
"site A",75,75,7,20,2,1,6,3
"site A",75,75,6,19,2,0,6,2
"site A",75,75,6,20,2,0,6,2
"site A",75,75,7,20,2,0,7,2
"site A",75,75,6,20,2,0,6,2
"site A",75,75,6,20,2,0,6,2
"site A",75,75,6,19,2,0,6,2
"site A",75,75,6,20,2,0,6,2
"site A",75,75,7,18,2,1,6,3
"site A",75,75,6,20,1,0,6,1
"site A",75,75,7,19,2,1,6,3
"site A",75,75,7,20,2,0,7,2
"site A",75,75,8,20,2,1,7,3
"site A",75,75,7,18,2,1,6,3
"site A",75,75,6,20,1,0,6,1
"site A",75,75,6,19,2,0,6,2
"site A",75,75,6,19,2,0,6,2
"site A",75,75,7,20,2,1,6,3
"site A",75,75,8,21,2,1,7,3
"site A",75,75,8,20,2,1,7,3
"site A",75,75,7,19,2,1,6,3
"site A",75,75,7,20,2,0,7,2
"site A",75,75,6,19,2,0,6,2
"site A",75,75,6,20,2,0,6,2
"site A",75,75,7,20,2,0,7,2
"site A",75,75,6,20,2,0,6,2
"site A",75,100,7,21,2,0,7,2
"site A",75,100,7,20,3,0,7,3
"site A",75,100,7,21,2,0,7,2
"site A",75,100,6,20,1,0,6,1
"site A",75,100,6,18,2,0,6,2
"site A",75,100,7,20,3,0,7,3
"site A",75,100,6,20,2,0,6,2
"site A",75,100,6,19,3,0,6,3
"site A",75,100,6,20,1,0,6,1
"site A",75,100,6,19,1,0,6,1
"site A",75,100,6,21,3,0,6,3
"site A",75,100,6,21,3,0,6,3
"site A",75,100,6,18,2,0,6,2
"site A",75,100,6,20,2,0,6,2
"site A",75,100,7,20,2,0,7,2
"site A",75,100,7,20,2,0,7,2
"site A",75,100,7,21,3,0,7,3
"site A",75,100,6,20,2,0,6,2
"site A",75,100,6,18,1,0,6,1
"site A",75,100,6,20,3,0,6,3
"site A",75,100,7,20,2,0,7,2
"site A",75,100,6,20,2,0,6,2
"site A",75,100,6,19,2,0,6,2
"site A",75,100,7,20,1,0,7,1
"site A",75,100,6,19,3,0,6,3
"site A",75,100,6,20,3,0,6,3
"site A",75,100,7,20,3,0,7,3
"site A",75,100,6,20,3,0,6,3
"site A",75,100,7,20,3,0,7,3
"site A",75,100,6,19,2,0,6,2
"site A",75,100,6,19,2,0,6,2
"site A",75,100,6,20,2,0,6,2
"site A",75,100,7,20,3,0,7,3
"site A",75,100,7,21,2,0,7,2
"site A",75,100,6,19,3,0,6,3
"site A",75,100,6,20,1,0,6,1
"site A",75,100,6,20,2,0,6,2
"site A",75,100,7,20,2,0,7,2
"site A",75,100,6,20,2,0,6,2
"site A",75,100,6,19,3,0,6,3
"site A",100,0,4,27,0,4,0,4
"site A",100,0,5,27,0,5,0,5
"site A",100,0,3,26,0,3,0,3
"site A",100,0,3,26,0,3,0,3
"site A",100,0,4,27,0,4,0,4
"site A",100,0,3,29,0,3,0,3
"site A",100,0,3,27,0,3,0,3
"site A",100,0,3,26,0,3,0,3
"site A",100,0,2,26,0,2,0,2
"site A",100,0,2,25,0,2,0,2
"site A",100,0,2,26,0,2,0,2
"site A",100,0,3,26,0,3,0,3
"site A",100,0,1,26,0,1,0,1
"site A",100,0,2,26,0,2,0,2
"site A",100,0,2,27,0,2,0,2
"site A",100,0,1,27,0,1,0,1
"site A",100,0,2,27,0,2,0,2
"site A",100,0,2,24,0,2,0,2
"site A",100,0,2,26,0,2,0,2
"site A",100,0,2,25,0,2,0,2
"site A",100,0,2,26,0,2,0,2
"site A",100,0,3,24,0,3,0,3
"site A",100,0,1,26,0,1,0,1
"site A",100,0,2,26,0,2,0,2
"site A",100,0,4,27,0,4,0,4
"site A",100,0,2,24,0,2,0,2
"site A",100,0,1,26,0,1,0,1
"site A",100,0,4,26,0,4,0,4
"site A",100,0,3,27,0,3,0,3
"site A",100,0,2,26,0,2,0,2
"site A",100,0,2,25,0,2,0,2
"site A",100,0,2,28,0,2,0,2
"site A",100,0,2,26,0,2,0,2
"site A",100,0,2,26,0,2,0,2
"site A",100,0,2,27,0,2,0,2
"site A",100,0,4,26,0,4,0,4
"site A",100,0,4,25,0,4,0,4
"site A",100,0,1,25,0,1,0,1
"site A",100,0,1,27,0,1,0,1
"site A",100,0,2,27,0,2,0,2
"site A",100,25,1,27,0,1,0,1
"site A",100,25,1,26,1,1,0,2
"site A",100,25,1,26,1,1,0,2
"site A",100,25,1,27,0,1,0,1
"site A",100,25,1,26,0,1,0,1
"site A",100,25,1,25,1,1,0,2
"site A",100,25,1,24,0,1,0,1
"site A",100,25,2,25,1,2,0,3
"site A",100,25,1,27,1,1,0,2
"site A",100,25,2,25,1,2,0,3
"site A",100,25,1,28,1,1,0,2
"site A",100,25,1,26,0,1,0,1
"site A",100,25,1,27,1,1,0,2
"site A",100,25,1,26,0,1,0,1
"site A",100,25,2,27,1,2,0,3
"site A",100,25,1,27,0,1,0,1
"site A",100,25,1,27,1,1,0,2
"site A",100,25,2,27,1,2,0,3
"site A",100,25,2,26,1,2,0,3
"site A",100,25,1,26,1,1,0,2
"site A",100,25,1,26,1,1,0,2
"site A",100,25,2,27,1,2,0,3
"site A",100,25,1,27,0,1,0,1
"site A",100,25,1,26,1,1,0,2
"site A",100,25,1,26,1,1,0,2
"site A",100,25,1,26,1,1,0,2
"site A",100,25,1,24,1,1,0,2
"site A",100,25,1,26,1,1,0,2
"site A",100,25,1,26,1,1,0,2
"site A",100,25,1,27,1,1,0,2
"site A",100,25,1,28,1,1,0,2
"site A",100,25,1,27,1,1,0,2
"site A",100,25,1,26,1,1,0,2
"site A",100,25,1,25,1,1,0,2
"site A",100,25,1,26,1,1,0,2
"site A",100,25,2,27,1,2,0,3
"site A",100,25,3,27,1,3,0,4
"site A",100,25,3,25,1,3,0,4
"site A",100,25,3,26,1,3,0,4
"site A",100,25,1,26,1,1,0,2
"site A",100,50,1,26,1,1,0,2
"site A",100,50,1,26,2,1,0,3
"site A",100,50,1,27,2,1,0,3
"site A",100,50,1,27,1,1,0,2
"site A",100,50,1,26,2,1,0,3
"site A",100,50,1,26,1,1,0,2
"site A",100,50,1,27,2,1,0,3
"site A",100,50,1,26,1,1,0,2
"site A",100,50,1,27,1,1,0,2
"site A",100,50,1,25,1,1,0,2
"site A",100,50,1,28,1,1,0,2
"site A",100,50,1,27,1,1,0,2
"site A",100,50,1,27,2,1,0,3
"site A",100,50,1,27,2,1,0,3
"site A",100,50,1,26,1,1,0,2
"site A",100,50,1,26,1,1,0,2
"site A",100,50,1,26,1,1,0,2
"site A",100,50,1,26,1,1,0,2
"site A",100,50,1,26,1,1,0,2
"site A",100,50,1,26,1,1,0,2
"site A",100,50,1,27,1,1,0,2
"site A",100,50,1,26,1,1,0,2
"site A",100,50,1,26,1,1,0,2
"site A",100,50,1,24,1,1,0,2
"site A",100,50,1,26,1,1,0,2
"site A",100,50,1,25,1,1,0,2
"site A",100,50,1,25,2,1,0,3
"site A",100,50,1,26,2,1,0,3
"site A",100,50,1,26,1,1,0,2
"site A",100,50,1,27,1,1,0,2
"site A",100,50,0,26,1,0,0,1
"site A",100,50,1,26,1,1,0,2
"site A",100,50,1,26,2,1,0,3
"site A",100,50,1,27,1,1,0,2
"site A",100,50,1,27,1,1,0,2
"site A",100,50,1,27,1,1,0,2
"site A",100,50,1,28,1,1,0,2
"site A",100,50,1,27,2,1,0,3
"site A",100,50,0,26,1,0,0,1
"site A",100,50,1,26,2,1,0,3
"site A",100,75,0,27,2,0,0,2
"site A",100,75,1,26,2,1,0,3
"site A",100,75,1,27,2,1,0,3
"site A",100,75,1,27,2,1,0,3
"site A",100,75,1,26,2,1,0,3
"site A",100,75,1,25,2,1,0,3
"site A",100,75,0,25,2,0,0,2
"site A",100,75,1,27,2,1,0,3
"site A",100,75,0,26,2,0,0,2
"site A",100,75,0,26,2,0,0,2
"site A",100,75,0,26,2,0,0,2
"site A",100,75,0,26,1,0,0,1
"site A",100,75,0,26,2,0,0,2
"site A",100,75,0,26,2,0,0,2
"site A",100,75,0,27,2,0,0,2
"site A",100,75,0,28,1,0,0,1
"site A",100,75,0,27,2,0,0,2
"site A",100,75,0,27,2,0,0,2
"site A",100,75,1,27,2,1,0,3
"site A",100,75,0,28,2,0,0,2
"site A",100,75,0,26,2,0,0,2
"site A",100,75,0,26,2,0,0,2
"site A",100,75,0,26,1,0,0,1
"site A",100,75,1,27,2,1,0,3
"site A",100,75,1,27,2,1,0,3
"site A",100,75,0,27,2,0,0,2
"site A",100,75,1,27,2,1,0,3
"site A",100,75,1,27,2,1,0,3
"site A",100,75,0,27,2,0,0,2
"site A",100,75,0,27,2,0,0,2
"site A",100,75,0,26,2,0,0,2
"site A",100,75,0,26,2,0,0,2
"site A",100,75,0,27,1,0,0,1
"site A",100,75,1,26,2,1,0,3
"site A",100,75,0,27,1,0,0,1
"site A",100,75,0,27,2,0,0,2
"site A",100,75,1,26,2,1,0,3
"site A",100,75,0,24,2,0,0,2
"site A",100,75,0,28,2,0,0,2
"site A",100,75,1,27,2,1,0,3
"site A",100,100,0,23,1,0,0,1
"site A",100,100,0,25,2,0,0,2
"site A",100,100,0,26,2,0,0,2
"site A",100,100,0,27,2,0,0,2
"site A",100,100,0,26,3,0,0,3
"site A",100,100,0,25,2,0,0,2
"site A",100,100,0,26,2,0,0,2
"site A",100,100,0,26,2,0,0,2
"site A",100,100,0,27,2,0,0,2
"site A",100,100,0,26,3,0,0,3
"site A",100,100,0,27,2,0,0,2
"site A",100,100,0,26,3,0,0,3
"site A",100,100,0,27,1,0,0,1
"site A",100,100,0,26,2,0,0,2
"site A",100,100,0,26,2,0,0,2
"site A",100,100,0,28,2,0,0,2
"site A",100,100,0,26,2,0,0,2
"site A",100,100,0,25,2,0,0,2
"site A",100,100,0,26,3,0,0,3
"site A",100,100,0,25,3,0,0,3
"site A",100,100,0,27,3,0,0,3
"site A",100,100,0,27,1,0,0,1
"site A",100,100,0,26,2,0,0,2
"site A",100,100,0,26,2,0,0,2
"site A",100,100,0,27,2,0,0,2
"site A",100,100,0,27,2,0,0,2
"site A",100,100,0,27,3,0,0,3
"site A",100,100,0,27,2,0,0,2
"site A",100,100,0,26,2,0,0,2
"site A",100,100,0,26,2,0,0,2
"site A",100,100,0,27,2,0,0,2
"site A",100,100,0,27,2,0,0,2
"site A",100,100,0,26,2,0,0,2
"site A",100,100,0,25,1,0,0,1
"site A",100,100,0,25,3,0,0,3
"site A",100,100,0,26,2,0,0,2
"site A",100,100,0,27,2,0,0,2
"site A",100,100,0,26,2,0,0,2
"site A",100,100,0,26,2,0,0,2
"site A",100,100,0,26,1,0,0,1
"site B",0,0,150,0,0,17,133,17
"site B",0,0,151,0,0,19,132,19
"site B",0,0,150,0,0,18,132,18
"site B",0,0,153,0,0,21,132,21
"site B",0,0,151,0,0,18,133,18
"site B",0,0,151,0,0,20,131,20
"site B",0,0,150,0,0,18,132,18
"site B",0,0,151,0,0,19,132,19
"site B",0,0,148,0,0,17,131,17
"site B",0,0,151,0,0,20,131,20
"site B",0,0,148,0,0,17,131,17
"site B",0,0,149,0,0,18,131,18
"site B",0,0,151,0,0,19,132,19
"site B",0,0,149,0,0,17,132,17
"site B",0,0,151,0,0,19,132,19
"site B",0,0,149,0,0,17,132,17
"site B",0,0,149,0,0,17,132,17
"site B",0,0,153,0,0,20,133,20
"site B",0,0,150,0,0,18,132,18
"site B",0,0,151,0,0,17,134,17
"site B",0,0,148,0,0,17,131,17
"site B",0,0,153,0,0,20,133,20
"site B",0,0,148,0,0,17,131,17
"site B",0,0,157,0,0,22,135,22
"site B",0,0,149,0,0,18,131,18
"site B",0,0,151,0,0,19,132,19
"site B",0,0,153,0,0,20,133,20
"site B",0,0,150,0,0,17,133,17
"site B",0,0,149,0,0,16,133,16
"site B",0,0,149,0,0,17,132,17
"site B",0,0,152,0,0,18,134,18
"site B",0,0,150,0,0,19,131,19
"site B",0,0,150,0,0,18,132,18
"site B",0,0,148,0,0,17,131,17
"site B",0,0,149,0,0,17,132,17
"site B",0,0,151,0,0,18,133,18
"site B",0,0,149,0,0,17,132,17
"site B",0,0,147,0,0,16,131,16
"site B",0,0,149,0,0,17,132,17
"site B",0,0,151,0,0,19,132,19
"site B",0,25,147,0,5,13,134,18
"site B",0,25,146,0,5,13,133,18
"site B",0,25,150,0,5,16,134,21
"site B",0,25,147,0,4,13,134,17
"site B",0,25,146,0,4,13,133,17
"site B",0,25,147,0,5,13,134,18
"site B",0,25,145,0,4,13,132,17
"site B",0,25,145,0,5,13,132,18
"site B",0,25,149,0,5,16,133,21
"site B",0,25,144,0,4,13,131,17
"site B",0,25,146,0,5,15,131,20
"site B",0,25,145,0,5,13,132,18
"site B",0,25,147,0,5,14,133,19
"site B",0,25,150,0,5,16,134,21
"site B",0,25,144,0,4,12,132,16
"site B",0,25,144,0,4,13,131,17
"site B",0,25,144,0,4,13,131,17
"site B",0,25,146,0,5,14,132,19
"site B",0,25,145,0,4,13,132,17
"site B",0,25,142,0,4,12,130,16
"site B",0,25,146,0,4,12,134,16
"site B",0,25,145,0,4,13,132,17
"site B",0,25,144,0,4,12,132,16
"site B",0,25,145,0,4,13,132,17
"site B",0,25,146,0,5,13,133,18
"site B",0,25,146,0,4,13,133,17
"site B",0,25,146,0,5,15,131,20
"site B",0,25,145,0,4,13,132,17
"site B",0,25,147,0,4,13,134,17
"site B",0,25,144,0,4,13,131,17
"site B",0,25,144,0,5,13,131,18
"site B",0,25,149,0,5,15,134,20
"site B",0,25,144,0,4,12,132,16
"site B",0,25,148,0,5,14,134,19
"site B",0,25,145,0,5,16,129,21
"site B",0,25,145,0,4,13,132,17
"site B",0,25,148,0,5,15,133,20
"site B",0,25,146,0,4,13,133,17
"site B",0,25,145,0,5,13,132,18
"site B",0,25,146,0,4,13,133,17
"site B",0,50,140,0,9,8,132,17
"site B",0,50,141,0,9,8,133,17
"site B",0,50,138,0,9,8,130,17
"site B",0,50,141,0,9,9,132,18
"site B",0,50,140,0,10,8,132,18
"site B",0,50,141,0,10,8,133,18
"site B",0,50,139,0,9,8,131,17
"site B",0,50,141,0,9,8,133,17
"site B",0,50,138,0,9,8,130,17
"site B",0,50,140,0,9,8,132,17
"site B",0,50,142,0,9,8,134,17
"site B",0,50,140,0,9,8,132,17
"site B",0,50,139,0,8,8,131,16
"site B",0,50,141,0,9,9,132,18
"site B",0,50,138,0,9,7,131,16
"site B",0,50,139,0,9,8,131,17
"site B",0,50,141,0,10,9,132,19
"site B",0,50,140,0,10,8,132,18
"site B",0,50,143,0,9,9,134,18
"site B",0,50,143,0,10,9,134,19
"site B",0,50,141,0,9,8,133,17
"site B",0,50,142,0,9,9,133,18
"site B",0,50,141,0,9,9,132,18
"site B",0,50,138,0,9,8,130,17
"site B",0,50,141,0,10,9,132,19
"site B",0,50,141,0,11,10,131,21
"site B",0,50,140,0,8,8,132,16
"site B",0,50,138,0,9,7,131,16
"site B",0,50,140,0,9,8,132,17
"site B",0,50,141,0,9,8,133,17
"site B",0,50,139,0,9,7,132,16
"site B",0,50,140,0,9,8,132,17
"site B",0,50,141,0,9,9,132,18
"site B",0,50,141,0,9,8,133,17
"site B",0,50,143,0,10,10,133,20
"site B",0,50,141,0,9,8,133,17
"site B",0,50,140,0,9,9,131,18
"site B",0,50,142,0,10,9,133,19
"site B",0,50,143,0,10,9,134,19
"site B",0,50,140,0,10,8,132,18
"site B",0,75,136,0,14,4,132,18
"site B",0,75,136,0,14,4,132,18
"site B",0,75,138,0,12,4,134,16
"site B",0,75,136,0,13,4,132,17
"site B",0,75,137,0,14,4,133,18
"site B",0,75,136,0,13,4,132,17
"site B",0,75,135,0,13,4,131,17
"site B",0,75,138,0,15,4,134,19
"site B",0,75,134,0,14,5,129,19
"site B",0,75,136,0,13,4,132,17
"site B",0,75,136,0,14,4,132,18
"site B",0,75,137,0,13,4,133,17
"site B",0,75,135,0,13,4,131,17
"site B",0,75,136,0,14,4,132,18
"site B",0,75,137,0,14,4,133,18
"site B",0,75,136,0,14,4,132,18
"site B",0,75,136,0,13,4,132,17
"site B",0,75,136,0,14,5,131,19
"site B",0,75,134,0,14,4,130,18
"site B",0,75,136,0,14,4,132,18
"site B",0,75,136,0,14,4,132,18
"site B",0,75,135,0,13,4,131,17
"site B",0,75,136,0,13,4,132,17
"site B",0,75,135,0,12,4,131,16
"site B",0,75,137,0,14,4,133,18
"site B",0,75,135,0,14,4,131,18
"site B",0,75,137,0,13,4,133,17
"site B",0,75,138,0,14,5,133,19
"site B",0,75,135,0,13,4,131,17
"site B",0,75,135,0,14,4,131,18
"site B",0,75,137,0,13,4,133,17
"site B",0,75,138,0,12,4,134,16
"site B",0,75,137,0,13,4,133,17
"site B",0,75,137,0,15,5,132,20
"site B",0,75,137,0,11,4,133,15
"site B",0,75,138,0,14,4,134,18
"site B",0,75,137,0,12,4,133,16
"site B",0,75,136,0,12,4,132,16
"site B",0,75,134,0,11,4,130,15
"site B",0,75,134,0,13,4,130,17
"site B",0,100,131,0,17,0,131,17
"site B",0,100,132,0,15,0,132,15
"site B",0,100,132,0,17,0,132,17
"site B",0,100,132,0,17,0,132,17
"site B",0,100,132,0,17,0,132,17
"site B",0,100,133,0,17,0,133,17
"site B",0,100,132,0,19,0,132,19
"site B",0,100,132,0,19,0,132,19
"site B",0,100,134,0,17,0,134,17
"site B",0,100,131,0,18,0,131,18
"site B",0,100,132,0,17,0,132,17
"site B",0,100,132,0,18,0,132,18
"site B",0,100,134,0,17,0,134,17
"site B",0,100,133,0,16,0,133,16
"site B",0,100,133,0,16,0,133,16
"site B",0,100,134,0,18,0,134,18
"site B",0,100,132,0,17,0,132,17
"site B",0,100,131,0,17,0,131,17
"site B",0,100,131,0,18,0,131,18
"site B",0,100,134,0,18,0,134,18
"site B",0,100,131,0,17,0,131,17
"site B",0,100,132,0,19,0,132,19
"site B",0,100,132,0,18,0,132,18
"site B",0,100,132,0,17,0,132,17
"site B",0,100,131,0,17,0,131,17
"site B",0,100,133,0,17,0,133,17
"site B",0,100,133,0,18,0,133,18
"site B",0,100,131,0,16,0,131,16
"site B",0,100,134,0,17,0,134,17
"site B",0,100,133,0,16,0,133,16
"site B",0,100,133,0,16,0,133,16
"site B",0,100,133,0,19,0,133,19
"site B",0,100,132,0,17,0,132,17
"site B",0,100,133,0,19,0,133,19
"site B",0,100,132,0,18,0,132,18
"site B",0,100,132,0,17,0,132,17
"site B",0,100,133,0,18,0,133,18
"site B",0,100,132,0,17,0,132,17
"site B",0,100,132,0,18,0,132,18
"site B",0,100,132,0,17,0,132,17
"site B",25,0,90,28,0,7,83,7
"site B",25,0,93,28,0,8,85,8
"site B",25,0,90,28,0,6,84,6
"site B",25,0,91,28,0,8,83,8
"site B",25,0,93,28,0,9,84,9
"site B",25,0,92,28,0,8,84,8
"site B",25,0,94,29,0,8,86,8
"site B",25,0,87,27,0,7,80,7
"site B",25,0,97,29,0,11,86,11
"site B",25,0,95,27,0,13,82,13
"site B",25,0,91,28,0,9,82,9
"site B",25,0,96,28,0,11,85,11
"site B",25,0,96,28,0,10,86,10
"site B",25,0,91,28,0,9,82,9
"site B",25,0,93,29,0,8,85,8
"site B",25,0,90,28,0,6,84,6
"site B",25,0,95,28,0,10,85,10
"site B",25,0,94,30,0,6,88,6
"site B",25,0,89,27,0,7,82,7
"site B",25,0,94,28,0,10,84,10
"site B",25,0,91,28,0,8,83,8
"site B",25,0,93,27,0,11,82,11
"site B",25,0,93,28,0,7,86,7
"site B",25,0,91,28,0,9,82,9
"site B",25,0,95,29,0,9,86,9
"site B",25,0,93,27,0,11,82,11
"site B",25,0,94,28,0,9,85,9
"site B",25,0,95,28,0,11,84,11
"site B",25,0,88,28,0,6,82,6
"site B",25,0,99,28,0,15,84,15
"site B",25,0,88,27,0,7,81,7
"site B",25,0,93,28,0,10,83,10
"site B",25,0,94,28,0,10,84,10
"site B",25,0,95,28,0,10,85,10
"site B",25,0,96,29,0,10,86,10
"site B",25,0,94,28,0,10,84,10
"site B",25,0,93,28,0,10,83,10
"site B",25,0,92,28,0,7,85,7
"site B",25,0,91,28,0,7,84,7
"site B",25,0,91,29,0,7,84,7
"site B",25,25,91,28,2,6,85,8
"site B",25,25,93,29,2,6,87,8
"site B",25,25,91,27,3,8,83,11
"site B",25,25,86,27,2,5,81,7
"site B",25,25,90,28,2,5,85,7
"site B",25,25,92,28,2,7,85,9
"site B",25,25,93,29,2,8,85,10
"site B",25,25,86,27,2,4,82,6
"site B",25,25,87,28,2,5,82,7
"site B",25,25,92,29,2,5,87,7
"site B",25,25,92,29,3,9,83,12
"site B",25,25,93,28,3,8,85,11
"site B",25,25,90,28,2,7,83,9
"site B",25,25,90,29,2,5,85,7
"site B",25,25,92,28,2,6,86,8
"site B",25,25,92,28,2,8,84,10
"site B",25,25,91,28,3,8,83,11
"site B",25,25,88,27,3,7,81,10
"site B",25,25,90,28,3,8,82,11
"site B",25,25,92,28,3,7,85,10
"site B",25,25,94,29,2,8,86,10
"site B",25,25,92,29,2,6,86,8
"site B",25,25,88,27,2,6,82,8
"site B",25,25,88,28,2,5,83,7
"site B",25,25,88,28,2,6,82,8
"site B",25,25,89,28,2,7,82,9
"site B",25,25,91,29,2,5,86,7
"site B",25,25,90,28,2,8,82,10
"site B",25,25,89,27,2,7,82,9
"site B",25,25,90,28,2,8,82,10
"site B",25,25,86,28,2,4,82,6
"site B",25,25,88,28,2,5,83,7
"site B",25,25,91,28,4,8,83,12
"site B",25,25,89,27,3,8,81,11
"site B",25,25,86,28,2,4,82,6
"site B",25,25,89,27,3,7,82,10
"site B",25,25,91,28,2,7,84,9
"site B",25,25,87,27,2,6,81,8
"site B",25,25,95,28,3,9,86,12
"site B",25,25,94,29,2,7,87,9
"site B",25,50,87,27,5,5,82,10
"site B",25,50,85,27,4,3,82,7
"site B",25,50,91,29,6,5,86,11
"site B",25,50,86,27,6,4,82,10
"site B",25,50,89,28,5,4,85,9
"site B",25,50,85,27,4,3,82,7
"site B",25,50,86,28,4,3,83,7
"site B",25,50,87,28,4,3,84,7
"site B",25,50,89,29,5,3,86,8
"site B",25,50,87,28,4,3,84,7
"site B",25,50,87,28,3,3,84,6
"site B",25,50,87,28,4,3,84,7
"site B",25,50,88,29,3,3,85,6
"site B",25,50,85,28,4,3,82,7
"site B",25,50,88,28,5,5,83,10
"site B",25,50,84,28,4,3,81,7
"site B",25,50,89,28,4,3,86,7
"site B",25,50,87,27,4,4,83,8
"site B",25,50,86,27,4,4,82,8
"site B",25,50,87,28,4,3,84,7
"site B",25,50,89,28,5,4,85,9
"site B",25,50,86,27,4,4,82,8
"site B",25,50,86,27,5,4,82,9
"site B",25,50,83,27,3,3,80,6
"site B",25,50,89,30,4,3,86,7
"site B",25,50,86,27,5,4,82,9
"site B",25,50,89,28,4,4,85,8
"site B",25,50,85,28,3,3,82,6
"site B",25,50,88,28,4,3,85,7
"site B",25,50,87,28,4,4,83,8
"site B",25,50,85,28,5,3,82,8
"site B",25,50,90,28,6,6,84,12
"site B",25,50,86,28,4,3,83,7
"site B",25,50,90,29,5,4,86,9
"site B",25,50,88,28,4,4,84,8
"site B",25,50,89,28,5,4,85,9
"site B",25,50,85,27,5,4,81,9
"site B",25,50,89,28,4,4,85,8
"site B",25,50,90,28,4,4,86,8
"site B",25,50,91,28,7,5,86,12
"site B",25,75,87,28,5,2,85,7
"site B",25,75,85,28,7,2,83,9
"site B",25,75,86,28,6,2,84,8
"site B",25,75,84,28,8,2,82,10
"site B",25,75,85,28,9,2,83,11
"site B",25,75,86,29,9,2,84,11
"site B",25,75,84,27,5,2,82,7
"site B",25,75,87,28,6,2,85,8
"site B",25,75,84,27,6,2,82,8
"site B",25,75,88,28,7,2,86,9
"site B",25,75,85,28,5,1,84,6
"site B",25,75,86,28,5,2,84,7
"site B",25,75,86,28,5,2,84,7
"site B",25,75,85,28,6,2,83,8
"site B",25,75,86,29,8,3,83,11
"site B",25,75,85,29,6,2,83,8
"site B",25,75,86,28,6,2,84,8
"site B",25,75,85,28,6,2,83,8
"site B",25,75,86,28,5,2,84,7
"site B",25,75,84,28,7,2,82,9
"site B",25,75,84,28,7,2,82,9
"site B",25,75,87,29,5,2,85,7
"site B",25,75,81,27,5,2,79,7
"site B",25,75,88,29,7,2,86,9
"site B",25,75,86,28,6,2,84,8
"site B",25,75,85,28,6,2,83,8
"site B",25,75,87,29,8,3,84,11
"site B",25,75,86,28,7,2,84,9
"site B",25,75,87,29,7,2,85,9
"site B",25,75,87,28,6,2,85,8
"site B",25,75,86,28,5,2,84,7
"site B",25,75,87,28,7,2,85,9
"site B",25,75,87,28,5,2,85,7
"site B",25,75,88,28,7,2,86,9
"site B",25,75,87,29,6,2,85,8
"site B",25,75,89,29,5,2,87,7
"site B",25,75,83,27,6,1,82,7
"site B",25,75,88,29,5,2,86,7
"site B",25,75,84,27,7,2,82,9
"site B",25,75,85,28,9,2,83,11
"site B",25,100,82,28,10,0,82,10
"site B",25,100,81,27,9,0,81,9
"site B",25,100,82,28,6,0,82,6
"site B",25,100,88,29,11,0,88,11
"site B",25,100,84,28,7,0,84,7
"site B",25,100,86,29,11,0,86,11
"site B",25,100,82,28,7,0,82,7
"site B",25,100,82,27,7,0,82,7
"site B",25,100,81,27,8,0,81,8
"site B",25,100,86,29,10,0,86,10
"site B",25,100,81,27,7,0,81,7
"site B",25,100,85,28,7,0,85,7
"site B",25,100,80,27,9,0,80,9
"site B",25,100,85,29,8,0,85,8
"site B",25,100,83,29,10,0,83,10
"site B",25,100,86,29,10,0,86,10
"site B",25,100,82,27,7,0,82,7
"site B",25,100,85,29,9,0,85,9
"site B",25,100,86,28,8,0,86,8
"site B",25,100,80,27,7,0,80,7
"site B",25,100,86,28,7,0,86,7
"site B",25,100,82,28,7,0,82,7
"site B",25,100,84,28,10,0,84,10
"site B",25,100,84,28,8,0,84,8
"site B",25,100,85,28,10,0,85,10
"site B",25,100,87,29,11,0,87,11
"site B",25,100,83,27,8,0,83,8
"site B",25,100,83,28,9,0,83,9
"site B",25,100,79,27,8,0,79,8
"site B",25,100,83,28,7,0,83,7
"site B",25,100,87,29,11,0,87,11
"site B",25,100,82,27,7,0,82,7
"site B",25,100,82,27,10,0,82,10
"site B",25,100,82,28,11,0,82,11
"site B",25,100,83,28,8,0,83,8
"site B",25,100,84,28,6,0,84,6
"site B",25,100,80,27,9,0,80,9
"site B",25,100,83,28,9,0,83,9
"site B",25,100,81,27,12,0,81,12
"site B",25,100,86,28,11,0,86,11
"site B",50,0,52,47,0,5,47,5
"site B",50,0,52,47,0,6,46,6
"site B",50,0,51,45,0,6,45,6
"site B",50,0,48,44,0,5,43,5
"site B",50,0,47,48,0,1,46,1
"site B",50,0,49,47,0,4,45,4
"site B",50,0,49,47,0,4,45,4
"site B",50,0,46,46,0,2,44,2
"site B",50,0,49,46,0,4,45,4
"site B",50,0,47,44,0,4,43,4
"site B",50,0,49,47,0,4,45,4
"site B",50,0,48,45,0,4,44,4
"site B",50,0,50,47,0,4,46,4
"site B",50,0,49,47,0,3,46,3
"site B",50,0,50,47,0,3,47,3
"site B",50,0,49,45,0,6,43,6
"site B",50,0,45,43,0,2,43,2
"site B",50,0,52,49,0,4,48,4
"site B",50,0,53,47,0,6,47,6
"site B",50,0,49,47,0,3,46,3
"site B",50,0,47,45,0,3,44,3
"site B",50,0,50,47,0,3,47,3
"site B",50,0,53,49,0,5,48,5
"site B",50,0,45,44,0,2,43,2
"site B",50,0,49,45,0,4,45,4
"site B",50,0,47,46,0,1,46,1
"site B",50,0,46,44,0,3,43,3
"site B",50,0,46,45,0,2,44,2
"site B",50,0,49,46,0,4,45,4
"site B",50,0,47,46,0,2,45,2
"site B",50,0,47,45,0,4,43,4
"site B",50,0,46,45,0,1,45,1
"site B",50,0,47,46,0,2,45,2
"site B",50,0,52,46,0,6,46,6
"site B",50,0,45,47,0,0,45,0
"site B",50,0,47,46,0,3,44,3
"site B",50,0,51,47,0,4,47,4
"site B",50,0,46,45,0,2,44,2
"site B",50,0,51,45,0,6,45,6
"site B",50,0,46,43,0,3,43,3
"site B",50,25,46,46,1,1,45,2
"site B",50,25,46,45,1,2,44,3
"site B",50,25,49,47,1,4,45,5
"site B",50,25,44,45,1,1,43,2
"site B",50,25,49,47,1,4,45,5
"site B",50,25,50,46,1,4,46,5
"site B",50,25,51,48,1,5,46,6
"site B",50,25,46,46,1,1,45,2
"site B",50,25,47,46,1,2,45,3
"site B",50,25,47,46,1,1,46,2
"site B",50,25,49,44,2,5,44,7
"site B",50,25,47,47,1,1,46,2
"site B",50,25,46,46,0,1,45,1
"site B",50,25,45,46,0,1,44,1
"site B",50,25,46,45,1,1,45,2
"site B",50,25,44,45,1,1,43,2
"site B",50,25,47,47,0,1,46,1
"site B",50,25,48,46,1,3,45,4
"site B",50,25,48,45,1,4,44,5
"site B",50,25,47,45,1,3,44,4
"site B",50,25,46,45,1,2,44,3
"site B",50,25,48,46,1,4,44,5
"site B",50,25,47,46,1,1,46,2
"site B",50,25,44,45,1,1,43,2
"site B",50,25,46,44,1,3,43,4
"site B",50,25,47,47,1,2,45,3
"site B",50,25,44,44,0,1,43,1
"site B",50,25,46,46,1,1,45,2
"site B",50,25,49,47,1,3,46,4
"site B",50,25,45,45,0,1,44,1
"site B",50,25,49,46,1,4,45,5
"site B",50,25,46,46,1,1,45,2
"site B",50,25,48,48,1,1,47,2
"site B",50,25,46,45,1,1,45,2
"site B",50,25,47,45,1,4,43,5
"site B",50,25,44,44,1,1,43,2
"site B",50,25,53,49,1,5,48,6
"site B",50,25,49,44,1,5,44,6
"site B",50,25,47,45,1,3,44,4
"site B",50,25,46,45,1,1,45,2
"site B",50,50,46,44,3,2,44,5
"site B",50,50,47,46,3,2,45,5
"site B",50,50,47,47,3,1,46,4
"site B",50,50,46,46,2,1,45,3
"site B",50,50,47,46,2,1,46,3
"site B",50,50,44,45,2,0,44,2
"site B",50,50,47,48,1,0,47,1
"site B",50,50,46,45,1,1,45,2
"site B",50,50,43,44,1,0,43,1
"site B",50,50,46,47,2,1,45,3
"site B",50,50,44,46,2,0,44,2
"site B",50,50,46,45,2,2,44,4
"site B",50,50,45,46,3,1,44,4
"site B",50,50,43,44,2,0,43,2
"site B",50,50,48,47,3,2,46,5
"site B",50,50,46,46,1,1,45,2
"site B",50,50,45,45,1,1,44,2
"site B",50,50,44,45,3,1,43,4
"site B",50,50,45,46,2,0,45,2
"site B",50,50,45,45,0,0,45,0
"site B",50,50,46,45,2,1,45,3
"site B",50,50,45,44,2,1,44,3
"site B",50,50,46,44,3,2,44,5
"site B",50,50,45,46,2,1,44,3
"site B",50,50,45,45,1,1,44,2
"site B",50,50,47,46,2,2,45,4
"site B",50,50,47,47,3,2,45,5
"site B",50,50,44,45,1,0,44,1
"site B",50,50,46,46,3,1,45,4
"site B",50,50,44,45,2,0,44,2
"site B",50,50,46,47,3,1,45,4
"site B",50,50,47,47,3,2,45,5
"site B",50,50,46,45,2,2,44,4
"site B",50,50,46,46,1,1,45,2
"site B",50,50,45,46,3,1,44,4
"site B",50,50,44,46,2,0,44,2
"site B",50,50,45,45,2,2,43,4
"site B",50,50,46,45,2,1,45,3
"site B",50,50,45,44,2,1,44,3
"site B",50,50,45,45,2,2,43,4
"site B",50,75,46,47,4,1,45,5
"site B",50,75,48,48,2,1,47,3
"site B",50,75,46,46,4,1,45,5
"site B",50,75,45,45,2,1,44,3
"site B",50,75,44,44,3,0,44,3
"site B",50,75,48,48,4,1,47,5
"site B",50,75,44,45,3,1,43,4
"site B",50,75,44,45,2,0,44,2
"site B",50,75,46,45,2,1,45,3
"site B",50,75,45,45,2,1,44,3
"site B",50,75,46,46,2,0,46,2
"site B",50,75,46,47,5,1,45,6
"site B",50,75,45,44,2,1,44,3
"site B",50,75,46,47,3,1,45,4
"site B",50,75,45,46,2,0,45,2
"site B",50,75,46,47,3,0,46,3
"site B",50,75,46,46,2,0,46,2
"site B",50,75,46,46,3,1,45,4
"site B",50,75,46,45,2,1,45,3
"site B",50,75,45,44,3,1,44,4
"site B",50,75,46,47,3,0,46,3
"site B",50,75,45,46,2,0,45,2
"site B",50,75,45,47,0,0,45,0
"site B",50,75,48,48,2,1,47,3
"site B",50,75,46,45,2,1,45,3
"site B",50,75,46,46,2,1,45,3
"site B",50,75,46,47,2,1,45,3
"site B",50,75,46,45,3,1,45,4
"site B",50,75,45,45,2,0,45,2
"site B",50,75,44,45,2,1,43,3
"site B",50,75,46,47,3,1,45,4
"site B",50,75,46,47,2,1,45,3
"site B",50,75,43,45,2,0,43,2
"site B",50,75,46,46,5,1,45,6
"site B",50,75,44,45,2,0,44,2
"site B",50,75,44,45,3,0,44,3
"site B",50,75,44,44,2,0,44,2
"site B",50,75,45,45,2,1,44,3
"site B",50,75,46,47,4,1,45,5
"site B",50,75,45,46,2,0,45,2
"site B",50,100,44,46,0,0,44,0
"site B",50,100,44,44,2,0,44,2
"site B",50,100,44,45,2,0,44,2
"site B",50,100,46,46,5,0,46,5
"site B",50,100,43,44,4,0,43,4
"site B",50,100,46,47,2,0,46,2
"site B",50,100,45,46,2,0,45,2
"site B",50,100,44,45,3,0,44,3
"site B",50,100,45,45,4,0,45,4
"site B",50,100,45,46,4,0,45,4
"site B",50,100,45,46,3,0,45,3
"site B",50,100,44,45,4,0,44,4
"site B",50,100,44,44,4,0,44,4
"site B",50,100,46,47,5,0,46,5
"site B",50,100,46,47,2,0,46,2
"site B",50,100,44,44,2,0,44,2
"site B",50,100,46,48,3,0,46,3
"site B",50,100,46,46,5,0,46,5
"site B",50,100,43,44,6,0,43,6
"site B",50,100,45,46,4,0,45,4
"site B",50,100,45,45,1,0,45,1
"site B",50,100,44,45,4,0,44,4
"site B",50,100,44,46,1,0,44,1
"site B",50,100,45,47,3,0,45,3
"site B",50,100,45,46,3,0,45,3
"site B",50,100,46,47,1,0,46,1
"site B",50,100,44,45,3,0,44,3
"site B",50,100,45,45,3,0,45,3
"site B",50,100,46,47,1,0,46,1
"site B",50,100,45,46,2,0,45,2
"site B",50,100,44,45,5,0,44,5
"site B",50,100,47,48,2,0,47,2
"site B",50,100,44,45,5,0,44,5
"site B",50,100,45,45,2,0,45,2
"site B",50,100,44,45,5,0,44,5
"site B",50,100,44,46,2,0,44,2
"site B",50,100,47,48,2,0,47,2
"site B",50,100,44,45,3,0,44,3
"site B",50,100,45,45,4,0,45,4
"site B",50,100,48,49,3,0,48,3
"site B",75,0,20,52,0,4,16,4
"site B",75,0,17,52,0,1,16,1
"site B",75,0,16,46,0,0,16,0
"site B",75,0,17,52,0,0,17,0
"site B",75,0,17,49,0,1,16,1
"site B",75,0,17,51,0,0,17,0
"site B",75,0,20,51,0,3,17,3
"site B",75,0,16,51,0,0,16,0
"site B",75,0,18,51,0,1,17,1
"site B",75,0,16,51,0,0,16,0
"site B",75,0,18,51,0,1,17,1
"site B",75,0,19,51,0,3,16,3
"site B",75,0,16,51,0,0,16,0
"site B",75,0,16,48,0,0,16,0
"site B",75,0,17,51,0,1,16,1
"site B",75,0,17,51,0,0,17,0
"site B",75,0,16,48,0,0,16,0
"site B",75,0,17,51,0,0,17,0
"site B",75,0,16,48,0,0,16,0
"site B",75,0,17,54,0,0,17,0
"site B",75,0,17,50,0,0,17,0
"site B",75,0,17,52,0,0,17,0
"site B",75,0,17,51,0,0,17,0
"site B",75,0,17,52,0,0,17,0
"site B",75,0,16,50,0,0,16,0
"site B",75,0,17,50,0,0,17,0
"site B",75,0,17,49,0,1,16,1
"site B",75,0,17,50,0,1,16,1
"site B",75,0,18,49,0,2,16,2
"site B",75,0,17,48,0,1,16,1
"site B",75,0,16,51,0,0,16,0
"site B",75,0,17,51,0,0,17,0
"site B",75,0,17,52,0,0,17,0
"site B",75,0,17,51,0,0,17,0
"site B",75,0,16,50,0,0,16,0
"site B",75,0,17,50,0,1,16,1
"site B",75,0,18,52,0,1,17,1
"site B",75,0,17,51,0,0,17,0
"site B",75,0,18,50,0,1,17,1
"site B",75,0,16,51,0,0,16,0
"site B",75,25,16,50,0,0,16,0
"site B",75,25,17,52,0,0,17,0
"site B",75,25,16,50,0,0,16,0
"site B",75,25,17,50,0,0,17,0
"site B",75,25,17,51,0,1,16,1
"site B",75,25,16,51,0,0,16,0
"site B",75,25,17,51,0,1,16,1
"site B",75,25,17,50,0,1,16,1
"site B",75,25,19,52,1,2,17,3
"site B",75,25,16,50,0,0,16,0
"site B",75,25,16,50,0,0,16,0
"site B",75,25,17,52,0,0,17,0
"site B",75,25,17,51,0,0,17,0
"site B",75,25,16,52,0,0,16,0
"site B",75,25,16,50,0,0,16,0
"site B",75,25,16,50,0,0,16,0
"site B",75,25,18,53,0,1,17,1
"site B",75,25,18,50,1,2,16,3
"site B",75,25,18,53,0,1,17,1
"site B",75,25,16,50,0,0,16,0
"site B",75,25,16,49,0,0,16,0
"site B",75,25,18,52,0,1,17,1
"site B",75,25,17,51,0,0,17,0
"site B",75,25,17,52,0,0,17,0
"site B",75,25,16,50,0,0,16,0
"site B",75,25,18,50,1,2,16,3
"site B",75,25,17,54,0,0,17,0
"site B",75,25,18,52,0,1,17,1
"site B",75,25,16,51,0,0,16,0
"site B",75,25,19,53,0,2,17,2
"site B",75,25,18,54,0,1,17,1
"site B",75,25,17,51,0,0,17,0
"site B",75,25,17,49,0,0,17,0
"site B",75,25,16,51,0,0,16,0
"site B",75,25,18,50,0,1,17,1
"site B",75,25,17,52,0,0,17,0
"site B",75,25,17,54,0,0,17,0
"site B",75,25,17,50,0,0,17,0
"site B",75,25,17,51,0,1,16,1
"site B",75,25,18,50,0,2,16,2
"site B",75,50,18,53,1,0,18,1
"site B",75,50,17,52,1,0,17,1
"site B",75,50,17,51,0,0,17,0
"site B",75,50,17,53,0,0,17,0
"site B",75,50,16,50,0,0,16,0
"site B",75,50,18,54,0,0,18,0
"site B",75,50,16,50,1,0,16,1
"site B",75,50,17,50,0,0,17,0
"site B",75,50,16,52,1,0,16,1
"site B",75,50,17,53,0,0,17,0
"site B",75,50,17,50,0,0,17,0
"site B",75,50,16,49,1,0,16,1
"site B",75,50,17,52,0,0,17,0
"site B",75,50,17,51,1,0,17,1
"site B",75,50,18,55,0,0,18,0
"site B",75,50,16,51,0,0,16,0
"site B",75,50,17,51,1,0,17,1
"site B",75,50,16,51,0,0,16,0
"site B",75,50,17,50,0,0,17,0
"site B",75,50,17,50,0,0,17,0
"site B",75,50,17,53,0,0,17,0
"site B",75,50,17,51,0,0,17,0
"site B",75,50,17,51,0,0,17,0
"site B",75,50,16,51,0,0,16,0
"site B",75,50,17,50,0,0,17,0
"site B",75,50,16,47,0,0,16,0
"site B",75,50,17,51,1,0,17,1
"site B",75,50,16,52,1,0,16,1
"site B",75,50,16,48,0,0,16,0
"site B",75,50,17,52,1,0,17,1
"site B",75,50,16,48,1,0,16,1
"site B",75,50,16,51,1,0,16,1
"site B",75,50,17,52,0,0,17,0
"site B",75,50,17,52,0,0,17,0
"site B",75,50,17,51,0,0,17,0
"site B",75,50,16,50,1,0,16,1
"site B",75,50,17,53,1,0,17,1
"site B",75,50,16,50,0,0,16,0
"site B",75,50,16,50,1,0,16,1
"site B",75,50,17,52,0,0,17,0
"site B",75,75,16,50,0,0,16,0
"site B",75,75,16,50,0,0,16,0
"site B",75,75,17,51,0,0,17,0
"site B",75,75,16,50,0,0,16,0
"site B",75,75,16,50,1,0,16,1
"site B",75,75,15,48,1,0,15,1
"site B",75,75,17,50,0,0,17,0
"site B",75,75,16,50,1,0,16,1
"site B",75,75,17,51,0,0,17,0
"site B",75,75,17,50,0,0,17,0
"site B",75,75,16,47,1,0,16,1
"site B",75,75,16,50,1,0,16,1
"site B",75,75,17,51,0,0,17,0
"site B",75,75,16,47,0,0,16,0
"site B",75,75,17,53,1,0,17,1
"site B",75,75,17,54,0,0,17,0
"site B",75,75,16,50,0,0,16,0
"site B",75,75,17,50,1,0,17,1
"site B",75,75,17,50,1,0,17,1
"site B",75,75,17,51,1,0,17,1
"site B",75,75,17,53,1,0,17,1
"site B",75,75,17,51,0,0,17,0
"site B",75,75,17,50,0,0,17,0
"site B",75,75,17,50,1,0,17,1
"site B",75,75,17,52,0,0,17,0
"site B",75,75,17,51,0,0,17,0
"site B",75,75,16,50,0,0,16,0
"site B",75,75,16,52,0,0,16,0
"site B",75,75,16,50,0,0,16,0
"site B",75,75,17,52,1,0,17,1
"site B",75,75,17,52,1,0,17,1
"site B",75,75,16,50,0,0,16,0
"site B",75,75,17,51,0,0,17,0
"site B",75,75,17,51,1,0,17,1
"site B",75,75,17,52,1,0,17,1
"site B",75,75,16,49,0,0,16,0
"site B",75,75,17,51,0,0,17,0
"site B",75,75,17,50,0,0,17,0
"site B",75,75,17,51,0,0,17,0
"site B",75,75,16,49,1,0,16,1
"site B",75,100,17,51,0,0,17,0
"site B",75,100,15,48,0,0,15,0
"site B",75,100,16,49,1,0,16,1
"site B",75,100,16,51,0,0,16,0
"site B",75,100,17,51,0,0,17,0
"site B",75,100,17,50,0,0,17,0
"site B",75,100,16,50,0,0,16,0
"site B",75,100,17,51,1,0,17,1
"site B",75,100,17,50,1,0,17,1
"site B",75,100,16,50,0,0,16,0
"site B",75,100,17,52,1,0,17,1
"site B",75,100,16,47,0,0,16,0
"site B",75,100,16,49,0,0,16,0
"site B",75,100,16,49,0,0,16,0
"site B",75,100,17,52,1,0,17,1
"site B",75,100,17,51,1,0,17,1
"site B",75,100,16,49,1,0,16,1
"site B",75,100,16,48,0,0,16,0
"site B",75,100,17,50,1,0,17,1
"site B",75,100,17,50,0,0,17,0
"site B",75,100,17,52,0,0,17,0
"site B",75,100,17,51,1,0,17,1
"site B",75,100,17,50,0,0,17,0
"site B",75,100,16,49,1,0,16,1
"site B",75,100,17,52,0,0,17,0
"site B",75,100,17,51,0,0,17,0
"site B",75,100,17,51,0,0,17,0
"site B",75,100,17,50,0,0,17,0
"site B",75,100,17,52,0,0,17,0
"site B",75,100,17,49,1,0,17,1
"site B",75,100,17,52,0,0,17,0
"site B",75,100,16,51,0,0,16,0
"site B",75,100,17,50,0,0,17,0
"site B",75,100,16,50,1,0,16,1
"site B",75,100,17,51,1,0,17,1
"site B",75,100,16,51,0,0,16,0
"site B",75,100,16,51,0,0,16,0
"site B",75,100,17,53,0,0,17,0
"site B",75,100,17,51,1,0,17,1
"site B",75,100,16,51,0,0,16,0
"site B",100,0,1,57,0,1,0,1
"site B",100,0,0,57,0,0,0,0
"site B",100,0,0,56,0,0,0,0
"site B",100,0,0,57,0,0,0,0
"site B",100,0,0,57,0,0,0,0
"site B",100,0,0,57,0,0,0,0
"site B",100,0,1,56,0,1,0,1
"site B",100,0,0,57,0,0,0,0
"site B",100,0,0,56,0,0,0,0
"site B",100,0,0,57,0,0,0,0
"site B",100,0,0,58,0,0,0,0
"site B",100,0,0,56,0,0,0,0
"site B",100,0,0,57,0,0,0,0
"site B",100,0,0,53,0,0,0,0
"site B",100,0,0,55,0,0,0,0
"site B",100,0,1,56,0,1,0,1
"site B",100,0,1,59,0,1,0,1
"site B",100,0,0,56,0,0,0,0
"site B",100,0,1,55,0,1,0,1
"site B",100,0,0,56,0,0,0,0
"site B",100,0,1,56,0,1,0,1
"site B",100,0,1,56,0,1,0,1
"site B",100,0,0,57,0,0,0,0
"site B",100,0,0,56,0,0,0,0
"site B",100,0,1,56,0,1,0,1
"site B",100,0,0,58,0,0,0,0
"site B",100,0,0,56,0,0,0,0
"site B",100,0,0,57,0,0,0,0
"site B",100,0,0,56,0,0,0,0
"site B",100,0,0,56,0,0,0,0
"site B",100,0,0,56,0,0,0,0
"site B",100,0,0,56,0,0,0,0
"site B",100,0,0,58,0,0,0,0
"site B",100,0,0,57,0,0,0,0
"site B",100,0,0,56,0,0,0,0
"site B",100,0,0,56,0,0,0,0
"site B",100,0,2,56,0,2,0,2
"site B",100,0,1,56,0,1,0,1
"site B",100,0,1,57,0,1,0,1
"site B",100,0,0,56,0,0,0,0
"site B",100,25,0,56,0,0,0,0
"site B",100,25,1,57,0,1,0,1
"site B",100,25,0,56,0,0,0,0
"site B",100,25,1,56,0,1,0,1
"site B",100,25,0,56,0,0,0,0
"site B",100,25,0,58,0,0,0,0
"site B",100,25,0,57,0,0,0,0
"site B",100,25,0,57,0,0,0,0
"site B",100,25,1,57,0,1,0,1
"site B",100,25,0,56,0,0,0,0
"site B",100,25,1,56,0,1,0,1
"site B",100,25,0,57,0,0,0,0
"site B",100,25,0,57,0,0,0,0
"site B",100,25,1,56,0,1,0,1
"site B",100,25,0,56,0,0,0,0
"site B",100,25,0,56,0,0,0,0
"site B",100,25,0,56,0,0,0,0
"site B",100,25,0,56,0,0,0,0
"site B",100,25,0,57,0,0,0,0
"site B",100,25,0,56,0,0,0,0
"site B",100,25,0,56,0,0,0,0
"site B",100,25,0,57,0,0,0,0
"site B",100,25,0,58,0,0,0,0
"site B",100,25,0,56,0,0,0,0
"site B",100,25,0,57,0,0,0,0
"site B",100,25,0,56,0,0,0,0
"site B",100,25,1,59,0,1,0,1
"site B",100,25,0,56,0,0,0,0
"site B",100,25,1,57,0,1,0,1
"site B",100,25,0,56,0,0,0,0
"site B",100,25,0,58,0,0,0,0
"site B",100,25,0,55,0,0,0,0
"site B",100,25,0,57,0,0,0,0
"site B",100,25,1,56,0,1,0,1
"site B",100,25,0,57,0,0,0,0
"site B",100,25,0,57,0,0,0,0
"site B",100,25,1,58,0,1,0,1
"site B",100,25,0,58,0,0,0,0
"site B",100,25,0,56,0,0,0,0
"site B",100,25,0,57,0,0,0,0
"site B",100,50,0,56,0,0,0,0
"site B",100,50,0,57,1,0,0,1
"site B",100,50,0,56,1,0,0,1
"site B",100,50,0,56,0,0,0,0
"site B",100,50,0,58,0,0,0,0
"site B",100,50,0,56,1,0,0,1
"site B",100,50,0,57,0,0,0,0
"site B",100,50,0,59,0,0,0,0
"site B",100,50,0,57,0,0,0,0
"site B",100,50,0,56,0,0,0,0
"site B",100,50,0,56,0,0,0,0
"site B",100,50,0,57,0,0,0,0
"site B",100,50,0,57,0,0,0,0
"site B",100,50,0,56,0,0,0,0
"site B",100,50,0,56,1,0,0,1
"site B",100,50,0,56,1,0,0,1
"site B",100,50,0,57,0,0,0,0
"site B",100,50,0,55,0,0,0,0
"site B",100,50,0,56,1,0,0,1
"site B",100,50,0,56,0,0,0,0
"site B",100,50,0,58,0,0,0,0
"site B",100,50,1,57,1,1,0,2
"site B",100,50,0,56,0,0,0,0
"site B",100,50,0,56,1,0,0,1
"site B",100,50,0,56,0,0,0,0
"site B",100,50,0,56,0,0,0,0
"site B",100,50,0,57,0,0,0,0
"site B",100,50,0,56,0,0,0,0
"site B",100,50,0,57,0,0,0,0
"site B",100,50,0,57,0,0,0,0
"site B",100,50,0,58,0,0,0,0
"site B",100,50,0,56,0,0,0,0
"site B",100,50,0,56,0,0,0,0
"site B",100,50,0,56,0,0,0,0
"site B",100,50,0,56,0,0,0,0
"site B",100,50,0,56,0,0,0,0
"site B",100,50,0,56,0,0,0,0
"site B",100,50,0,56,0,0,0,0
"site B",100,50,0,57,1,0,0,1
"site B",100,50,0,58,1,0,0,1
"site B",100,75,0,58,1,0,0,1
"site B",100,75,0,57,0,0,0,0
"site B",100,75,0,56,0,0,0,0
"site B",100,75,0,57,1,0,0,1
"site B",100,75,0,58,0,0,0,0
"site B",100,75,0,57,1,0,0,1
"site B",100,75,0,56,0,0,0,0
"site B",100,75,0,57,0,0,0,0
"site B",100,75,0,56,0,0,0,0
"site B",100,75,0,56,0,0,0,0
"site B",100,75,0,57,0,0,0,0
"site B",100,75,0,57,0,0,0,0
"site B",100,75,0,56,0,0,0,0
"site B",100,75,0,58,0,0,0,0
"site B",100,75,0,56,1,0,0,1
"site B",100,75,0,57,0,0,0,0
"site B",100,75,0,56,1,0,0,1
"site B",100,75,0,57,0,0,0,0
"site B",100,75,0,57,0,0,0,0
"site B",100,75,0,57,0,0,0,0
"site B",100,75,0,57,0,0,0,0
"site B",100,75,0,56,0,0,0,0
"site B",100,75,0,56,0,0,0,0
"site B",100,75,0,57,1,0,0,1
"site B",100,75,0,56,0,0,0,0
"site B",100,75,0,58,0,0,0,0
"site B",100,75,0,56,0,0,0,0
"site B",100,75,0,57,1,0,0,1
"site B",100,75,0,56,0,0,0,0
"site B",100,75,0,57,1,0,0,1
"site B",100,75,0,57,1,0,0,1
"site B",100,75,0,56,0,0,0,0
"site B",100,75,0,56,1,0,0,1
"site B",100,75,0,57,2,0,0,2
"site B",100,75,0,56,0,0,0,0
"site B",100,75,0,56,1,0,0,1
"site B",100,75,0,55,0,0,0,0
"site B",100,75,0,56,1,0,0,1
"site B",100,75,0,56,1,0,0,1
"site B",100,75,0,56,0,0,0,0
"site B",100,100,0,57,0,0,0,0
"site B",100,100,0,58,1,0,0,1
"site B",100,100,0,59,1,0,0,1
"site B",100,100,0,57,1,0,0,1
"site B",100,100,0,57,0,0,0,0
"site B",100,100,0,58,0,0,0,0
"site B",100,100,0,57,0,0,0,0
"site B",100,100,0,56,1,0,0,1
"site B",100,100,0,56,1,0,0,1
"site B",100,100,0,56,0,0,0,0
"site B",100,100,0,58,0,0,0,0
"site B",100,100,0,57,0,0,0,0
"site B",100,100,0,56,0,0,0,0
"site B",100,100,0,56,0,0,0,0
"site B",100,100,0,57,1,0,0,1
"site B",100,100,0,56,0,0,0,0
"site B",100,100,0,55,0,0,0,0
"site B",100,100,0,54,1,0,0,1
"site B",100,100,0,58,0,0,0,0
"site B",100,100,0,57,0,0,0,0
"site B",100,100,0,57,1,0,0,1
"site B",100,100,0,57,1,0,0,1
"site B",100,100,0,57,0,0,0,0
"site B",100,100,0,58,0,0,0,0
"site B",100,100,0,58,0,0,0,0
"site B",100,100,0,57,0,0,0,0
"site B",100,100,0,57,1,0,0,1
"site B",100,100,0,57,1,0,0,1
"site B",100,100,0,57,0,0,0,0
"site B",100,100,0,56,1,0,0,1
"site B",100,100,0,55,0,0,0,0
"site B",100,100,0,56,0,0,0,0
"site B",100,100,0,57,1,0,0,1
"site B",100,100,0,56,0,0,0,0
"site B",100,100,0,56,0,0,0,0
"site B",100,100,0,57,1,0,0,1
"site B",100,100,0,56,1,0,0,1
"site B",100,100,0,57,1,0,0,1
"site B",100,100,0,56,0,0,0,0
"site B",100,100,0,57,0,0,0,0
"site C",0,0,143,0,0,74,69,74
"site C",0,0,139,0,0,70,69,70
"site C",0,0,143,0,0,71,72,71
"site C",0,0,144,0,0,74,70,74
"site C",0,0,141,0,0,72,69,72
"site C",0,0,147,0,0,75,72,75
"site C",0,0,148,0,0,76,72,76
"site C",0,0,144,0,0,73,71,73
"site C",0,0,147,0,0,76,71,76
"site C",0,0,143,0,0,73,70,73
"site C",0,0,147,0,0,75,72,75
"site C",0,0,147,0,0,75,72,75
"site C",0,0,142,0,0,71,71,71
"site C",0,0,143,0,0,71,72,71
"site C",0,0,145,0,0,75,70,75
"site C",0,0,146,0,0,76,70,76
"site C",0,0,139,0,0,68,71,68
"site C",0,0,142,0,0,70,72,70
"site C",0,0,137,0,0,69,68,69
"site C",0,0,148,0,0,77,71,77
"site C",0,0,146,0,0,75,71,75
"site C",0,0,150,0,0,78,72,78
"site C",0,0,144,0,0,72,72,72
"site C",0,0,142,0,0,71,71,71
"site C",0,0,148,0,0,78,70,78
"site C",0,0,142,0,0,71,71,71
"site C",0,0,141,0,0,72,69,72
"site C",0,0,147,0,0,75,72,75
"site C",0,0,139,0,0,72,67,72
"site C",0,0,153,0,0,81,72,81
"site C",0,0,143,0,0,74,69,74
"site C",0,0,140,0,0,72,68,72
"site C",0,0,145,0,0,74,71,74
"site C",0,0,142,0,0,72,70,72
"site C",0,0,142,0,0,73,69,73
"site C",0,0,151,0,0,81,70,81
"site C",0,0,147,0,0,76,71,76
"site C",0,0,148,0,0,75,73,75
"site C",0,0,136,0,0,68,68,68
"site C",0,0,144,0,0,74,70,74
"site C",0,25,116,0,16,44,72,60
"site C",0,25,113,0,16,45,68,61
"site C",0,25,117,0,16,48,69,64
"site C",0,25,113,0,14,44,69,58
"site C",0,25,119,0,18,51,68,69
"site C",0,25,116,0,15,46,70,61
"site C",0,25,113,0,16,46,67,62
"site C",0,25,119,0,17,47,72,64
"site C",0,25,116,0,16,47,69,63
"site C",0,25,123,0,18,51,72,69
"site C",0,25,119,0,16,49,70,65
"site C",0,25,118,0,16,47,71,63
"site C",0,25,118,0,17,50,68,67
"site C",0,25,118,0,17,47,71,64
"site C",0,25,116,0,16,45,71,61
"site C",0,25,120,0,15,47,73,62
"site C",0,25,120,0,17,48,72,65
"site C",0,25,117,0,17,47,70,64
"site C",0,25,116,0,16,46,70,62
"site C",0,25,114,0,16,46,68,62
"site C",0,25,116,0,16,46,70,62
"site C",0,25,122,0,17,51,71,68
"site C",0,25,116,0,15,47,69,62
"site C",0,25,122,0,17,50,72,67
"site C",0,25,116,0,16,46,70,62
"site C",0,25,115,0,15,47,68,62
"site C",0,25,114,0,15,45,69,60
"site C",0,25,119,0,16,47,72,63
"site C",0,25,120,0,16,48,72,64
"site C",0,25,116,0,16,46,70,62
"site C",0,25,115,0,15,45,70,60
"site C",0,25,119,0,16,47,72,63
"site C",0,25,115,0,15,46,69,61
"site C",0,25,116,0,16,48,68,64
"site C",0,25,113,0,16,45,68,61
"site C",0,25,120,0,17,49,71,66
"site C",0,25,122,0,18,50,72,68
"site C",0,25,120,0,16,49,71,65
"site C",0,25,115,0,16,44,71,60
"site C",0,25,115,0,16,46,69,62
"site C",0,50,94,0,25,25,69,50
"site C",0,50,99,0,31,29,70,60
"site C",0,50,98,0,29,28,70,57
"site C",0,50,99,0,28,27,72,55
"site C",0,50,96,0,27,25,71,52
"site C",0,50,99,0,28,27,72,55
"site C",0,50,95,0,28,26,69,54
"site C",0,50,98,0,27,27,71,54
"site C",0,50,99,0,28,27,72,55
"site C",0,50,95,0,27,25,70,52
"site C",0,50,95,0,27,27,68,54
"site C",0,50,95,0,27,25,70,52
"site C",0,50,93,0,27,26,67,53
"site C",0,50,96,0,30,29,67,59
"site C",0,50,99,0,27,27,72,54
"site C",0,50,96,0,27,27,69,54
"site C",0,50,97,0,28,27,70,55
"site C",0,50,100,0,29,28,72,57
"site C",0,50,94,0,27,27,67,54
"site C",0,50,101,0,29,29,72,58
"site C",0,50,93,0,27,25,68,52
"site C",0,50,91,0,24,23,68,47
"site C",0,50,96,0,27,27,69,54
"site C",0,50,100,0,29,29,71,58
"site C",0,50,100,0,29,28,72,57
"site C",0,50,93,0,26,25,68,51
"site C",0,50,96,0,29,27,69,56
"site C",0,50,99,0,29,28,71,57
"site C",0,50,97,0,28,26,71,54
"site C",0,50,96,0,27,26,70,53
"site C",0,50,101,0,30,30,71,60
"site C",0,50,98,0,29,27,71,56
"site C",0,50,100,0,27,27,73,54
"site C",0,50,96,0,28,27,69,55
"site C",0,50,93,0,26,25,68,51
"site C",0,50,95,0,25,25,70,50
"site C",0,50,97,0,29,28,69,57
"site C",0,50,100,0,29,28,72,57
"site C",0,50,95,0,27,25,70,52
"site C",0,50,95,0,28,27,68,55
"site C",0,75,79,0,31,11,68,42
"site C",0,75,83,0,35,12,71,47
"site C",0,75,80,0,31,10,70,41
"site C",0,75,83,0,32,11,72,43
"site C",0,75,80,0,36,11,69,47
"site C",0,75,82,0,34,11,71,45
"site C",0,75,81,0,34,11,70,45
"site C",0,75,81,0,37,12,69,49
"site C",0,75,80,0,33,11,69,44
"site C",0,75,78,0,33,10,68,43
"site C",0,75,78,0,34,10,68,44
"site C",0,75,83,0,33,11,72,44
"site C",0,75,80,0,34,11,69,45
"site C",0,75,80,0,34,10,70,44
"site C",0,75,82,0,36,11,71,47
"site C",0,75,84,0,36,12,72,48
"site C",0,75,80,0,34,10,70,44
"site C",0,75,77,0,32,11,66,43
"site C",0,75,81,0,34,12,69,46
"site C",0,75,80,0,35,12,68,47
"site C",0,75,85,0,34,12,73,46
"site C",0,75,79,0,34,10,69,44
"site C",0,75,81,0,29,9,72,38
"site C",0,75,81,0,32,11,70,43
"site C",0,75,80,0,31,11,69,42
"site C",0,75,81,0,29,10,71,39
"site C",0,75,79,0,28,9,70,37
"site C",0,75,86,0,34,12,74,46
"site C",0,75,78,0,35,12,66,47
"site C",0,75,81,0,31,10,71,41
"site C",0,75,84,0,36,12,72,48
"site C",0,75,80,0,28,9,71,37
"site C",0,75,82,0,31,10,72,41
"site C",0,75,83,0,35,12,71,47
"site C",0,75,84,0,36,12,72,48
"site C",0,75,80,0,35,11,69,46
"site C",0,75,82,0,35,11,71,46
"site C",0,75,78,0,32,11,67,43
"site C",0,75,83,0,35,12,71,47
"site C",0,75,78,0,29,9,69,38
"site C",0,100,71,0,32,0,71,32
"site C",0,100,72,0,36,0,72,36
"site C",0,100,72,0,30,0,72,30
"site C",0,100,73,0,34,0,73,34
"site C",0,100,70,0,35,0,70,35
"site C",0,100,72,0,34,0,72,34
"site C",0,100,70,0,32,0,70,32
"site C",0,100,72,0,31,0,72,31
"site C",0,100,70,0,31,0,70,31
"site C",0,100,71,0,34,0,71,34
"site C",0,100,72,0,32,0,72,32
"site C",0,100,69,0,32,0,69,32
"site C",0,100,68,0,32,0,68,32
"site C",0,100,66,0,34,0,66,34
"site C",0,100,71,0,34,0,71,34
"site C",0,100,71,0,34,0,71,34
"site C",0,100,71,0,34,0,71,34
"site C",0,100,72,0,33,0,72,33
"site C",0,100,70,0,36,0,70,36
"site C",0,100,72,0,36,0,72,36
"site C",0,100,69,0,31,0,69,31
"site C",0,100,72,0,36,0,72,36
"site C",0,100,69,0,32,0,69,32
"site C",0,100,70,0,34,0,70,34
"site C",0,100,69,0,33,0,69,33
"site C",0,100,70,0,31,0,70,31
"site C",0,100,69,0,34,0,69,34
"site C",0,100,68,0,33,0,68,33
"site C",0,100,73,0,34,0,73,34
"site C",0,100,67,0,32,0,67,32
"site C",0,100,67,0,32,0,67,32
"site C",0,100,70,0,32,0,70,32
"site C",0,100,71,0,34,0,71,34
"site C",0,100,72,0,36,0,72,36
"site C",0,100,72,0,34,0,72,34
"site C",0,100,70,0,31,0,70,31
"site C",0,100,70,0,29,0,70,29
"site C",0,100,70,0,33,0,70,33
"site C",0,100,71,0,30,0,71,30
"site C",0,100,70,0,29,0,70,29
"site C",25,0,114,15,0,69,45,69
"site C",25,0,108,16,0,63,45,63
"site C",25,0,113,15,0,70,43,70
"site C",25,0,110,15,0,63,47,63
"site C",25,0,113,15,0,66,47,66
"site C",25,0,119,15,0,73,46,73
"site C",25,0,111,14,0,67,44,67
"site C",25,0,109,14,0,66,43,66
"site C",25,0,111,15,0,64,47,64
"site C",25,0,111,15,0,65,46,65
"site C",25,0,120,16,0,73,47,73
"site C",25,0,111,16,0,64,47,64
"site C",25,0,113,16,0,67,46,67
"site C",25,0,106,15,0,61,45,61
"site C",25,0,118,15,0,72,46,72
"site C",25,0,110,15,0,63,47,63
"site C",25,0,112,15,0,69,43,69
"site C",25,0,111,15,0,66,45,66
"site C",25,0,112,15,0,65,47,65
"site C",25,0,109,15,0,64,45,64
"site C",25,0,114,15,0,70,44,70
"site C",25,0,108,15,0,62,46,62
"site C",25,0,112,15,0,67,45,67
"site C",25,0,104,14,0,61,43,61
"site C",25,0,112,16,0,66,46,66
"site C",25,0,109,16,0,65,44,65
"site C",25,0,113,16,0,67,46,67
"site C",25,0,110,16,0,64,46,64
"site C",25,0,109,16,0,62,47,62
"site C",25,0,121,15,0,74,47,74
"site C",25,0,107,15,0,63,44,63
"site C",25,0,114,16,0,69,45,69
"site C",25,0,114,15,0,69,45,69
"site C",25,0,110,16,0,65,45,65
"site C",25,0,113,15,0,70,43,70
"site C",25,0,109,13,0,69,40,69
"site C",25,0,99,14,0,59,40,59
"site C",25,0,117,15,0,73,44,73
"site C",25,0,117,15,0,71,46,71
"site C",25,0,108,15,0,63,45,63
"site C",25,25,83,14,14,41,42,55
"site C",25,25,84,14,14,42,42,56
"site C",25,25,89,16,15,44,45,59
"site C",25,25,79,13,13,38,41,51
"site C",25,25,87,15,14,42,45,56
"site C",25,25,93,15,16,47,46,63
"site C",25,25,88,15,14,41,47,55
"site C",25,25,82,14,14,41,41,55
"site C",25,25,83,15,14,40,43,54
"site C",25,25,93,15,15,47,46,62
"site C",25,25,89,15,15,43,46,58
"site C",25,25,85,14,15,44,41,59
"site C",25,25,92,15,16,47,45,63
"site C",25,25,86,15,13,40,46,53
"site C",25,25,91,15,15,44,47,59
"site C",25,25,84,16,14,40,44,54
"site C",25,25,82,15,13,38,44,51
"site C",25,25,85,15,14,39,46,53
"site C",25,25,82,15,13,39,43,52
"site C",25,25,89,15,15,43,46,58
"site C",25,25,86,15,14,41,45,55
"site C",25,25,87,14,16,45,42,61
"site C",25,25,86,14,15,44,42,59
"site C",25,25,80,14,13,40,40,53
"site C",25,25,84,16,14,40,44,54
"site C",25,25,88,15,14,42,46,56
"site C",25,25,86,15,14,41,45,55
"site C",25,25,82,14,14,40,42,54
"site C",25,25,85,14,14,41,44,55
"site C",25,25,86,14,15,46,40,61
"site C",25,25,83,15,13,38,45,51
"site C",25,25,87,14,15,43,44,58
"site C",25,25,87,15,14,43,44,57
"site C",25,25,93,16,15,47,46,62
"site C",25,25,84,15,14,38,46,52
"site C",25,25,89,16,15,43,46,58
"site C",25,25,89,15,16,46,43,62
"site C",25,25,85,15,14,40,45,54
"site C",25,25,85,15,13,39,46,52
"site C",25,25,88,15,15,43,45,58
"site C",25,50,67,14,23,23,44,46
"site C",25,50,69,16,24,22,47,46
"site C",25,50,70,15,25,24,46,49
"site C",25,50,73,16,27,26,47,53
"site C",25,50,68,15,26,24,44,50
"site C",25,50,67,15,25,24,43,49
"site C",25,50,67,15,23,22,45,45
"site C",25,50,68,16,23,22,46,45
"site C",25,50,67,15,24,23,44,47
"site C",25,50,64,13,23,23,41,46
"site C",25,50,69,15,23,22,47,45
"site C",25,50,65,15,22,21,44,43
"site C",25,50,67,15,23,23,44,46
"site C",25,50,63,15,22,20,43,42
"site C",25,50,70,15,25,23,47,48
"site C",25,50,72,15,26,25,47,51
"site C",25,50,66,15,23,23,43,46
"site C",25,50,65,14,23,22,43,45
"site C",25,50,66,15,24,22,44,46
"site C",25,50,67,15,24,22,45,46
"site C",25,50,65,15,25,23,42,48
"site C",25,50,71,15,26,24,47,50
"site C",25,50,66,15,23,21,45,44
"site C",25,50,66,14,24,23,43,47
"site C",25,50,65,15,24,23,42,47
"site C",25,50,65,14,24,23,42,47
"site C",25,50,65,15,25,23,42,48
"site C",25,50,66,15,25,24,42,49
"site C",25,50,64,14,24,22,42,46
"site C",25,50,67,16,24,23,44,47
"site C",25,50,63,15,22,22,41,44
"site C",25,50,69,15,24,23,46,47
"site C",25,50,69,15,25,24,45,49
"site C",25,50,67,15,25,23,44,48
"site C",25,50,65,14,24,22,43,46
"site C",25,50,68,15,23,22,46,45
"site C",25,50,66,15,23,22,44,45
"site C",25,50,69,16,24,24,45,48
"site C",25,50,72,16,25,25,47,50
"site C",25,50,72,15,28,27,45,55
"site C",25,75,56,16,30,9,47,39
"site C",25,75,56,16,28,9,47,37
"site C",25,75,55,16,29,10,45,39
"site C",25,75,53,15,24,8,45,32
"site C",25,75,54,15,27,9,45,36
"site C",25,75,53,15,24,7,46,31
"site C",25,75,52,14,29,9,43,38
"site C",25,75,51,15,27,8,43,35
"site C",25,75,49,13,25,8,41,33
"site C",25,75,50,15,28,9,41,37
"site C",25,75,56,16,30,10,46,40
"site C",25,75,53,15,28,9,44,37
"site C",25,75,54,16,27,9,45,36
"site C",25,75,52,14,28,9,43,37
"site C",25,75,52,14,30,9,43,39
"site C",25,75,52,14,28,8,44,36
"site C",25,75,54,16,31,10,44,41
"site C",25,75,52,15,31,10,42,41
"site C",25,75,54,16,25,9,45,34
"site C",25,75,51,14,27,8,43,35
"site C",25,75,55,15,28,9,46,37
"site C",25,75,57,16,29,10,47,39
"site C",25,75,57,16,29,10,47,39
"site C",25,75,53,16,26,8,45,34
"site C",25,75,55,16,28,10,45,38
"site C",25,75,51,15,28,8,43,36
"site C",25,75,52,15,27,8,44,35
"site C",25,75,51,15,27,8,43,35
"site C",25,75,51,14,29,10,41,39
"site C",25,75,49,14,25,9,40,34
"site C",25,75,56,16,29,10,46,39
"site C",25,75,54,15,33,10,44,43
"site C",25,75,53,15,28,8,45,36
"site C",25,75,55,16,29,9,46,38
"site C",25,75,52,15,28,9,43,37
"site C",25,75,54,15,30,10,44,40
"site C",25,75,53,14,28,9,44,37
"site C",25,75,50,14,26,8,42,34
"site C",25,75,48,15,24,7,41,31
"site C",25,75,55,15,28,8,47,36
"site C",25,100,47,15,28,0,47,28
"site C",25,100,45,15,28,0,45,28
"site C",25,100,45,15,27,0,45,27
"site C",25,100,47,16,28,0,47,28
"site C",25,100,44,15,26,0,44,26
"site C",25,100,46,16,30,0,46,30
"site C",25,100,46,16,29,0,46,29
"site C",25,100,46,16,28,0,46,28
"site C",25,100,44,14,27,0,44,27
"site C",25,100,44,14,29,0,44,29
"site C",25,100,46,15,27,0,46,27
"site C",25,100,46,15,26,0,46,26
"site C",25,100,42,15,32,0,42,32
"site C",25,100,46,16,27,0,46,27
"site C",25,100,47,17,29,0,47,29
"site C",25,100,44,14,30,0,44,30
"site C",25,100,46,16,27,0,46,27
"site C",25,100,47,16,27,0,47,27
"site C",25,100,46,15,29,0,46,29
"site C",25,100,44,14,30,0,44,30
"site C",25,100,46,15,29,0,46,29
"site C",25,100,44,14,29,0,44,29
"site C",25,100,47,15,29,0,47,29
"site C",25,100,44,15,29,0,44,29
"site C",25,100,47,15,31,0,47,31
"site C",25,100,45,15,30,0,45,30
"site C",25,100,44,15,29,0,44,29
"site C",25,100,43,14,26,0,43,26
"site C",25,100,45,15,30,0,45,30
"site C",25,100,46,16,29,0,46,29
"site C",25,100,44,16,28,0,44,28
"site C",25,100,46,16,29,0,46,29
"site C",25,100,46,16,27,0,46,27
"site C",25,100,43,15,30,0,43,30
"site C",25,100,41,15,27,0,41,27
"site C",25,100,44,14,30,0,44,30
"site C",25,100,44,16,32,0,44,32
"site C",25,100,41,15,28,0,41,28
"site C",25,100,47,16,29,0,47,29
"site C",25,100,47,16,29,0,47,29
"site C",50,0,76,25,0,52,24,52
"site C",50,0,82,25,0,59,23,59
"site C",50,0,83,24,0,60,23,60
"site C",50,0,83,25,0,59,24,59
"site C",50,0,82,26,0,56,26,56
"site C",50,0,90,28,0,63,27,63
"site C",50,0,77,24,0,54,23,54
"site C",50,0,80,25,0,56,24,56
"site C",50,0,84,25,0,60,24,60
"site C",50,0,82,24,0,59,23,59
"site C",50,0,83,24,0,61,22,61
"site C",50,0,77,24,0,53,24,53
"site C",50,0,80,24,0,56,24,56
"site C",50,0,75,24,0,52,23,52
"site C",50,0,87,24,0,64,23,64
"site C",50,0,79,25,0,55,24,55
"site C",50,0,88,26,0,63,25,63
"site C",50,0,91,25,0,67,24,67
"site C",50,0,78,26,0,54,24,54
"site C",50,0,81,26,0,56,25,56
"site C",50,0,78,26,0,54,24,54
"site C",50,0,81,24,0,58,23,58
"site C",50,0,74,25,0,51,23,51
"site C",50,0,84,26,0,58,26,58
"site C",50,0,81,26,0,57,24,57
"site C",50,0,82,27,0,56,26,56
"site C",50,0,86,26,0,60,26,60
"site C",50,0,81,26,0,56,25,56
"site C",50,0,87,27,0,61,26,61
"site C",50,0,86,26,0,61,25,61
"site C",50,0,77,24,0,54,23,54
"site C",50,0,84,26,0,60,24,60
"site C",50,0,81,24,0,58,23,58
"site C",50,0,81,24,0,58,23,58
"site C",50,0,82,26,0,58,24,58
"site C",50,0,76,25,0,52,24,52
"site C",50,0,77,24,0,53,24,53
"site C",50,0,84,26,0,60,24,60
"site C",50,0,81,24,0,58,23,58
"site C",50,0,82,25,0,59,23,59
"site C",50,25,65,26,13,39,26,52
"site C",50,25,58,25,13,35,23,48
"site C",50,25,62,26,13,36,26,49
"site C",50,25,63,25,13,39,24,52
"site C",50,25,60,26,12,35,25,47
"site C",50,25,61,25,13,36,25,49
"site C",50,25,58,24,11,35,23,46
"site C",50,25,63,26,13,38,25,51
"site C",50,25,55,25,11,31,24,42
"site C",50,25,59,25,12,36,23,48
"site C",50,25,60,24,12,37,23,49
"site C",50,25,60,25,13,37,23,50
"site C",50,25,62,25,13,38,24,51
"site C",50,25,57,26,11,33,24,44
"site C",50,25,57,25,12,34,23,46
"site C",50,25,61,24,12,37,24,49
"site C",50,25,58,25,12,34,24,46
"site C",50,25,58,23,13,35,23,48
"site C",50,25,58,25,12,35,23,47
"site C",50,25,62,26,13,37,25,50
"site C",50,25,64,26,14,40,24,54
"site C",50,25,57,24,12,34,23,46
"site C",50,25,56,24,12,33,23,45
"site C",50,25,62,26,13,37,25,50
"site C",50,25,56,23,12,34,22,46
"site C",50,25,61,26,12,36,25,48
"site C",50,25,58,25,11,33,25,44
"site C",50,25,59,25,13,35,24,48
"site C",50,25,58,26,11,33,25,44
"site C",50,25,61,24,13,37,24,50
"site C",50,25,58,26,12,34,24,46
"site C",50,25,60,25,12,36,24,48
"site C",50,25,60,26,13,35,25,48
"site C",50,25,64,25,13,39,25,52
"site C",50,25,65,25,14,41,24,55
"site C",50,25,57,25,12,34,23,46
"site C",50,25,64,26,13,39,25,52
"site C",50,25,58,24,12,34,24,46
"site C",50,25,61,24,13,38,23,51
"site C",50,25,61,22,13,39,22,52
"site C",50,50,43,25,20,19,24,39
"site C",50,50,42,24,19,19,23,38
"site C",50,50,46,25,23,21,25,44
"site C",50,50,44,25,19,19,25,38
"site C",50,50,41,24,19,19,22,38
"site C",50,50,41,24,21,19,22,40
"site C",50,50,43,23,20,20,23,40
"site C",50,50,40,25,18,17,23,35
"site C",50,50,46,26,22,21,25,43
"site C",50,50,43,25,20,19,24,39
"site C",50,50,43,24,21,20,23,41
"site C",50,50,47,26,22,22,25,44
"site C",50,50,45,24,23,22,23,45
"site C",50,50,44,26,21,20,24,41
"site C",50,50,46,24,23,22,24,45
"site C",50,50,44,25,21,20,24,41
"site C",50,50,43,25,20,19,24,39
"site C",50,50,40,25,18,17,23,35
"site C",50,50,43,26,19,18,25,37
"site C",50,50,43,26,20,18,25,38
"site C",50,50,43,25,21,20,23,41
"site C",50,50,41,25,19,18,23,37
"site C",50,50,42,25,20,18,24,38
"site C",50,50,43,25,20,18,25,38
"site C",50,50,42,25,21,19,23,40
"site C",50,50,45,26,21,20,25,41
"site C",50,50,45,26,21,20,25,41
"site C",50,50,45,25,21,20,25,41
"site C",50,50,41,24,19,18,23,37
"site C",50,50,46,26,22,21,25,43
"site C",50,50,44,25,21,20,24,41
"site C",50,50,44,27,20,18,26,38
"site C",50,50,43,26,21,19,24,40
"site C",50,50,43,27,20,18,25,38
"site C",50,50,40,24,18,17,23,35
"site C",50,50,45,26,22,20,25,42
"site C",50,50,42,23,21,20,22,41
"site C",50,50,44,26,20,18,26,38
"site C",50,50,46,25,22,21,25,43
"site C",50,50,45,26,22,20,25,42
"site C",50,75,32,26,24,8,24,32
"site C",50,75,33,25,25,9,24,34
"site C",50,75,31,24,23,8,23,31
"site C",50,75,31,24,24,7,24,31
"site C",50,75,31,25,25,8,23,33
"site C",50,75,34,25,28,9,25,37
"site C",50,75,33,26,25,8,25,33
"site C",50,75,34,25,25,9,25,34
"site C",50,75,32,25,23,8,24,31
"site C",50,75,34,25,26,9,25,35
"site C",50,75,31,25,21,7,24,28
"site C",50,75,32,25,26,8,24,34
"site C",50,75,31,24,23,8,23,31
"site C",50,75,30,25,22,7,23,29
"site C",50,75,32,25,25,9,23,34
"site C",50,75,30,24,22,7,23,29
"site C",50,75,33,26,27,8,25,35
"site C",50,75,34,26,27,9,25,36
"site C",50,75,33,26,24,7,26,31
"site C",50,75,31,25,24,7,24,31
"site C",50,75,31,25,21,7,24,28
"site C",50,75,32,24,24,8,24,32
"site C",50,75,30,25,22,7,23,29
"site C",50,75,32,26,22,8,24,30
"site C",50,75,30,25,24,7,23,31
"site C",50,75,31,25,20,7,24,27
"site C",50,75,30,25,22,7,23,29
"site C",50,75,31,25,22,7,24,29
"site C",50,75,34,26,25,9,25,34
"site C",50,75,31,25,22,7,24,29
"site C",50,75,33,26,22,8,25,30
"site C",50,75,31,25,26,8,23,34
"site C",50,75,31,25,22,7,24,29
"site C",50,75,31,25,25,7,24,32
"site C",50,75,33,26,23,8,25,31
"site C",50,75,33,26,24,8,25,32
"site C",50,75,31,24,22,7,24,29
"site C",50,75,32,25,25,8,24,33
"site C",50,75,30,24,23,7,23,30
"site C",50,75,33,26,25,8,25,33
"site C",50,100,22,24,25,0,22,25
"site C",50,100,23,24,27,0,23,27
"site C",50,100,25,25,25,0,25,25
"site C",50,100,25,25,27,0,25,27
"site C",50,100,23,25,27,0,23,27
"site C",50,100,25,25,26,0,25,26
"site C",50,100,24,24,25,0,24,25
"site C",50,100,24,26,24,0,24,24
"site C",50,100,25,27,24,0,25,24
"site C",50,100,23,25,26,0,23,26
"site C",50,100,23,25,24,0,23,24
"site C",50,100,24,25,29,0,24,29
"site C",50,100,24,26,25,0,24,25
"site C",50,100,25,26,27,0,25,27
"site C",50,100,23,25,27,0,23,27
"site C",50,100,25,27,27,0,25,27
"site C",50,100,24,25,28,0,24,28
"site C",50,100,24,24,26,0,24,26
"site C",50,100,24,25,28,0,24,28
"site C",50,100,26,26,27,0,26,27
"site C",50,100,25,25,27,0,25,27
"site C",50,100,23,25,24,0,23,24
"site C",50,100,23,24,25,0,23,25
"site C",50,100,24,25,27,0,24,27
"site C",50,100,24,25,26,0,24,26
"site C",50,100,26,26,25,0,26,25
"site C",50,100,25,27,28,0,25,28
"site C",50,100,24,24,26,0,24,26
"site C",50,100,23,24,26,0,23,26
"site C",50,100,23,25,28,0,23,28
"site C",50,100,24,25,27,0,24,27
"site C",50,100,25,25,26,0,25,26
"site C",50,100,25,25,27,0,25,27
"site C",50,100,23,23,29,0,23,29
"site C",50,100,23,25,28,0,23,28
"site C",50,100,24,25,28,0,24,28
"site C",50,100,22,24,26,0,22,26
"site C",50,100,23,24,25,0,23,25
"site C",50,100,22,24,26,0,22,26
"site C",50,100,23,23,26,0,23,26
"site C",75,0,65,34,0,55,10,55
"site C",75,0,60,34,0,50,10,50
"site C",75,0,61,32,0,51,10,51
"site C",75,0,61,32,0,51,10,51
"site C",75,0,61,32,0,51,10,51
"site C",75,0,60,32,0,50,10,50
"site C",75,0,62,32,0,52,10,52
"site C",75,0,60,33,0,50,10,50
"site C",75,0,65,31,0,55,10,55
"site C",75,0,68,32,0,58,10,58
"site C",75,0,63,33,0,53,10,53
"site C",75,0,62,34,0,51,11,51
"site C",75,0,72,32,0,62,10,62
"site C",75,0,66,32,0,56,10,56
"site C",75,0,60,33,0,50,10,50
"site C",75,0,61,34,0,50,11,50
"site C",75,0,60,34,0,50,10,50
"site C",75,0,66,33,0,56,10,56
"site C",75,0,62,32,0,52,10,52
"site C",75,0,66,34,0,55,11,55
"site C",75,0,62,32,0,52,10,52
"site C",75,0,64,34,0,54,10,54
"site C",75,0,65,34,0,55,10,55
"site C",75,0,59,32,0,49,10,49
"site C",75,0,61,31,0,51,10,51
"site C",75,0,56,34,0,46,10,46
"site C",75,0,60,33,0,50,10,50
"site C",75,0,61,33,0,51,10,51
"site C",75,0,59,34,0,49,10,49
"site C",75,0,66,31,0,56,10,56
"site C",75,0,62,32,0,52,10,52
"site C",75,0,63,32,0,53,10,53
"site C",75,0,60,32,0,50,10,50
"site C",75,0,58,34,0,48,10,48
"site C",75,0,59,35,0,48,11,48
"site C",75,0,64,32,0,54,10,54
"site C",75,0,58,33,0,48,10,48
"site C",75,0,66,33,0,56,10,56
"site C",75,0,62,31,0,52,10,52
"site C",75,0,69,33,0,59,10,59
"site C",75,25,43,33,12,33,10,45
"site C",75,25,38,34,9,27,11,36
"site C",75,25,39,31,11,29,10,40
"site C",75,25,40,33,11,30,10,41
"site C",75,25,44,31,12,34,10,46
"site C",75,25,42,35,11,31,11,42
"site C",75,25,42,33,10,32,10,42
"site C",75,25,41,32,11,31,10,42
"site C",75,25,42,34,10,31,11,41
"site C",75,25,39,34,11,29,10,40
"site C",75,25,47,31,12,37,10,49
"site C",75,25,43,33,12,33,10,45
"site C",75,25,44,33,11,34,10,45
"site C",75,25,41,33,11,31,10,42
"site C",75,25,39,32,10,29,10,39
"site C",75,25,46,33,12,36,10,48
"site C",75,25,47,33,12,37,10,49
"site C",75,25,44,34,12,33,11,45
"site C",75,25,44,34,11,34,10,45
"site C",75,25,43,32,11,33,10,44
"site C",75,25,44,31,12,34,10,46
"site C",75,25,41,34,10,31,10,41
"site C",75,25,39,33,11,29,10,40
"site C",75,25,42,32,11,32,10,43
"site C",75,25,45,33,11,35,10,46
"site C",75,25,44,34,11,33,11,44
"site C",75,25,42,33,12,32,10,44
"site C",75,25,45,31,12,35,10,47
"site C",75,25,41,34,11,30,11,41
"site C",75,25,42,33,11,32,10,43
"site C",75,25,45,31,12,35,10,47
"site C",75,25,42,34,11,32,10,43
"site C",75,25,44,34,12,34,10,46
"site C",75,25,42,32,10,32,10,42
"site C",75,25,47,32,12,37,10,49
"site C",75,25,41,32,11,31,10,42
"site C",75,25,43,32,11,33,10,44
"site C",75,25,39,32,10,29,10,39
"site C",75,25,40,32,11,30,10,41
"site C",75,25,40,33,11,30,10,41
"site C",75,50,27,32,18,17,10,35
"site C",75,50,28,31,18,17,11,35
"site C",75,50,26,33,17,16,10,33
"site C",75,50,29,33,19,18,11,37
"site C",75,50,29,33,20,19,10,39
"site C",75,50,29,34,19,18,11,37
"site C",75,50,29,34,18,18,11,36
"site C",75,50,25,31,17,15,10,32
"site C",75,50,26,31,17,16,10,33
"site C",75,50,31,34,20,20,11,40
"site C",75,50,28,32,18,18,10,36
"site C",75,50,29,32,21,19,10,40
"site C",75,50,28,32,19,18,10,37
"site C",75,50,27,32,19,17,10,36
"site C",75,50,28,32,18,18,10,36
"site C",75,50,28,33,19,18,10,37
"site C",75,50,28,34,18,18,10,36
"site C",75,50,28,31,18,18,10,36
"site C",75,50,28,32,19,18,10,37
"site C",75,50,25,33,17,15,10,32
"site C",75,50,27,33,18,17,10,35
"site C",75,50,27,32,17,17,10,34
"site C",75,50,26,31,17,16,10,33
"site C",75,50,29,33,19,19,10,38
"site C",75,50,27,33,18,17,10,35
"site C",75,50,27,33,17,17,10,34
"site C",75,50,28,31,19,18,10,37
"site C",75,50,28,33,19,18,10,37
"site C",75,50,27,33,18,17,10,35
"site C",75,50,27,33,18,17,10,35
"site C",75,50,27,33,19,17,10,36
"site C",75,50,29,33,19,19,10,38
"site C",75,50,26,32,17,16,10,33
"site C",75,50,27,33,19,17,10,36
"site C",75,50,31,33,21,20,11,41
"site C",75,50,27,33,18,17,10,35
"site C",75,50,28,32,19,18,10,37
"site C",75,50,28,32,19,18,10,37
"site C",75,50,27,32,18,17,10,35
"site C",75,50,29,34,18,18,11,36
"site C",75,75,17,33,22,7,10,29
"site C",75,75,17,33,22,7,10,29
"site C",75,75,18,33,23,8,10,31
"site C",75,75,17,31,22,7,10,29
"site C",75,75,17,33,20,6,11,26
"site C",75,75,16,32,19,6,10,25
"site C",75,75,18,34,22,8,10,30
"site C",75,75,18,33,21,7,11,28
"site C",75,75,16,31,22,6,10,28
"site C",75,75,16,34,20,6,10,26
"site C",75,75,18,31,25,8,10,33
"site C",75,75,18,31,24,8,10,32
"site C",75,75,18,32,21,7,11,28
"site C",75,75,18,34,22,7,11,29
"site C",75,75,18,33,22,8,10,30
"site C",75,75,16,32,22,6,10,28
"site C",75,75,17,33,25,7,10,32
"site C",75,75,16,33,22,6,10,28
"site C",75,75,17,33,22,7,10,29
"site C",75,75,18,32,23,8,10,31
"site C",75,75,17,32,21,7,10,28
"site C",75,75,16,34,22,6,10,28
"site C",75,75,18,32,25,8,10,33
"site C",75,75,16,32,22,6,10,28
"site C",75,75,17,33,22,7,10,29
"site C",75,75,18,33,24,8,10,32
"site C",75,75,17,32,23,7,10,30
"site C",75,75,16,32,21,6,10,27
"site C",75,75,17,33,23,7,10,30
"site C",75,75,16,33,21,6,10,27
"site C",75,75,19,32,26,9,10,35
"site C",75,75,18,32,22,8,10,30
"site C",75,75,17,33,21,7,10,28
"site C",75,75,17,32,22,7,10,29
"site C",75,75,18,33,22,8,10,30
"site C",75,75,17,33,21,7,10,28
"site C",75,75,16,32,22,6,10,28
"site C",75,75,17,32,23,7,10,30
"site C",75,75,17,31,22,7,10,29
"site C",75,75,17,33,23,7,10,30
"site C",75,100,10,32,26,0,10,26
"site C",75,100,10,33,28,0,10,28
"site C",75,100,10,32,28,0,10,28
"site C",75,100,10,34,28,0,10,28
"site C",75,100,10,32,27,0,10,27
"site C",75,100,10,31,26,0,10,26
"site C",75,100,10,32,28,0,10,28
"site C",75,100,10,32,24,0,10,24
"site C",75,100,10,31,26,0,10,26
"site C",75,100,10,33,27,0,10,27
"site C",75,100,11,34,27,0,11,27
"site C",75,100,10,33,27,0,10,27
"site C",75,100,10,33,27,0,10,27
"site C",75,100,10,33,27,0,10,27
"site C",75,100,10,33,26,0,10,26
"site C",75,100,10,30,26,0,10,26
"site C",75,100,10,32,27,0,10,27
"site C",75,100,11,33,25,0,11,25
"site C",75,100,11,33,26,0,11,26
"site C",75,100,10,34,29,0,10,29
"site C",75,100,10,33,24,0,10,24
"site C",75,100,10,31,27,0,10,27
"site C",75,100,10,33,31,0,10,31
"site C",75,100,10,32,28,0,10,28
"site C",75,100,11,33,28,0,11,28
"site C",75,100,10,33,28,0,10,28
"site C",75,100,10,34,26,0,10,26
"site C",75,100,10,33,26,0,10,26
"site C",75,100,10,33,26,0,10,26
"site C",75,100,10,34,27,0,10,27
"site C",75,100,10,31,26,0,10,26
"site C",75,100,11,34,27,0,11,27
"site C",75,100,10,31,26,0,10,26
"site C",75,100,10,33,26,0,10,26
"site C",75,100,10,34,27,0,10,27
"site C",75,100,10,31,26,0,10,26
"site C",75,100,10,32,26,0,10,26
"site C",75,100,10,32,26,0,10,26
"site C",75,100,10,32,25,0,10,25
"site C",75,100,10,31,27,0,10,27
"site C",100,0,43,43,0,43,0,43
"site C",100,0,44,40,0,44,0,44
"site C",100,0,47,41,0,47,0,47
"site C",100,0,47,42,0,47,0,47
"site C",100,0,48,41,0,48,0,48
"site C",100,0,45,40,0,45,0,45
"site C",100,0,47,41,0,47,0,47
"site C",100,0,48,41,0,48,0,48
"site C",100,0,47,41,0,47,0,47
"site C",100,0,46,41,0,46,0,46
"site C",100,0,46,40,0,46,0,46
"site C",100,0,46,42,0,46,0,46
"site C",100,0,49,42,0,49,0,49
"site C",100,0,46,41,0,46,0,46
"site C",100,0,46,41,0,46,0,46
"site C",100,0,44,42,0,44,0,44
"site C",100,0,44,41,0,44,0,44
"site C",100,0,43,41,0,43,0,43
"site C",100,0,48,42,0,48,0,48
"site C",100,0,44,42,0,44,0,44
"site C",100,0,48,42,0,48,0,48
"site C",100,0,43,41,0,43,0,43
"site C",100,0,43,40,0,43,0,43
"site C",100,0,38,42,0,38,0,38
"site C",100,0,41,42,0,41,0,41
"site C",100,0,45,42,0,45,0,45
"site C",100,0,51,42,0,51,0,51
"site C",100,0,44,41,0,44,0,44
"site C",100,0,45,41,0,45,0,45
"site C",100,0,46,42,0,46,0,46
"site C",100,0,42,41,0,42,0,42
"site C",100,0,47,42,0,47,0,47
"site C",100,0,45,42,0,45,0,45
"site C",100,0,42,41,0,42,0,42
"site C",100,0,48,42,0,48,0,48
"site C",100,0,44,41,0,44,0,44
"site C",100,0,46,42,0,46,0,46
"site C",100,0,45,42,0,45,0,45
"site C",100,0,43,41,0,43,0,43
"site C",100,0,41,42,0,41,0,41
"site C",100,25,29,41,10,29,0,39
"site C",100,25,28,42,10,28,0,38
"site C",100,25,28,42,10,28,0,38
"site C",100,25,27,42,10,27,0,37
"site C",100,25,31,41,11,31,0,42
"site C",100,25,28,41,10,28,0,38
"site C",100,25,23,42,9,23,0,32
"site C",100,25,26,41,8,26,0,34
"site C",100,25,29,40,10,29,0,39
"site C",100,25,26,42,9,26,0,35
"site C",100,25,28,42,10,28,0,38
"site C",100,25,31,42,10,31,0,41
"site C",100,25,30,41,10,30,0,40
"site C",100,25,26,42,9,26,0,35
"site C",100,25,30,41,10,30,0,40
"site C",100,25,29,42,10,29,0,39
"site C",100,25,28,41,10,28,0,38
"site C",100,25,30,42,10,30,0,40
"site C",100,25,29,41,10,29,0,39
"site C",100,25,26,42,8,26,0,34
"site C",100,25,26,41,9,26,0,35
"site C",100,25,31,42,10,31,0,41
"site C",100,25,22,41,7,22,0,29
"site C",100,25,25,40,9,25,0,34
"site C",100,25,30,42,10,30,0,40
"site C",100,25,32,42,10,32,0,42
"site C",100,25,24,41,9,24,0,33
"site C",100,25,31,42,11,31,0,42
"site C",100,25,26,42,8,26,0,34
"site C",100,25,30,41,10,30,0,40
"site C",100,25,30,43,10,30,0,40
"site C",100,25,27,42,10,27,0,37
"site C",100,25,27,41,10,27,0,37
"site C",100,25,25,41,9,25,0,34
"site C",100,25,28,42,10,28,0,38
"site C",100,25,28,41,10,28,0,38
"site C",100,25,29,41,10,29,0,39
"site C",100,25,27,41,9,27,0,36
"site C",100,25,29,42,9,29,0,38
"site C",100,25,26,41,9,26,0,35
"site C",100,50,13,42,14,13,0,27
"site C",100,50,16,42,16,16,0,32
"site C",100,50,16,42,16,16,0,32
"site C",100,50,15,42,16,15,0,31
"site C",100,50,18,41,18,18,0,36
"site C",100,50,14,41,14,14,0,28
"site C",100,50,15,41,16,15,0,31
"site C",100,50,14,40,15,14,0,29
"site C",100,50,15,41,17,15,0,32
"site C",100,50,15,40,17,15,0,32
"site C",100,50,13,41,15,13,0,28
"site C",100,50,14,42,16,14,0,30
"site C",100,50,13,42,15,13,0,28
"site C",100,50,16,42,16,16,0,32
"site C",100,50,16,42,17,16,0,33
"site C",100,50,16,42,17,16,0,33
"site C",100,50,15,41,15,15,0,30
"site C",100,50,14,42,14,14,0,28
"site C",100,50,16,41,17,16,0,33
"site C",100,50,12,42,14,12,0,26
"site C",100,50,14,41,15,14,0,29
"site C",100,50,14,41,14,14,0,28
"site C",100,50,15,42,15,15,0,30
"site C",100,50,16,42,16,16,0,32
"site C",100,50,15,41,16,15,0,31
"site C",100,50,14,42,15,14,0,29
"site C",100,50,14,41,14,14,0,28
"site C",100,50,15,41,17,15,0,32
"site C",100,50,14,41,14,14,0,28
"site C",100,50,15,41,17,15,0,32
"site C",100,50,17,42,18,17,0,35
"site C",100,50,15,41,17,15,0,32
"site C",100,50,15,41,15,15,0,30
"site C",100,50,15,42,16,15,0,31
"site C",100,50,13,42,15,13,0,28
"site C",100,50,18,41,19,18,0,37
"site C",100,50,15,41,16,15,0,31
"site C",100,50,14,41,14,14,0,28
"site C",100,50,16,41,17,16,0,33
"site C",100,50,18,41,19,18,0,37
"site C",100,75,7,40,21,7,0,28
"site C",100,75,6,42,20,6,0,26
"site C",100,75,6,41,21,6,0,27
"site C",100,75,8,42,23,8,0,31
"site C",100,75,6,42,19,6,0,25
"site C",100,75,6,41,20,6,0,26
"site C",100,75,6,42,20,6,0,26
"site C",100,75,6,42,22,6,0,28
"site C",100,75,7,41,22,7,0,29
"site C",100,75,6,41,21,6,0,27
"site C",100,75,6,41,20,6,0,26
"site C",100,75,7,41,20,7,0,27
"site C",100,75,7,40,21,7,0,28
"site C",100,75,7,42,20,7,0,27
"site C",100,75,6,42,20,6,0,26
"site C",100,75,6,41,20,6,0,26
"site C",100,75,7,41,22,7,0,29
"site C",100,75,6,42,19,6,0,25
"site C",100,75,6,41,19,6,0,25
"site C",100,75,7,42,21,7,0,28
"site C",100,75,6,42,21,6,0,27
"site C",100,75,7,41,21,7,0,28
"site C",100,75,7,42,20,7,0,27
"site C",100,75,7,42,21,7,0,28
"site C",100,75,7,42,21,7,0,28
"site C",100,75,6,41,20,6,0,26
"site C",100,75,7,41,21,7,0,28
"site C",100,75,6,41,20,6,0,26
"site C",100,75,7,42,21,7,0,28
"site C",100,75,6,40,20,6,0,26
"site C",100,75,7,43,23,7,0,30
"site C",100,75,8,40,24,8,0,32
"site C",100,75,6,41,20,6,0,26
"site C",100,75,6,42,21,6,0,27
"site C",100,75,6,40,20,6,0,26
"site C",100,75,6,41,21,6,0,27
"site C",100,75,8,42,22,8,0,30
"site C",100,75,7,41,20,7,0,27
"site C",100,75,7,41,20,7,0,27
"site C",100,75,6,41,21,6,0,27
"site C",100,100,0,41,25,0,0,25
"site C",100,100,0,41,30,0,0,30
"site C",100,100,0,42,25,0,0,25
"site C",100,100,0,41,25,0,0,25
"site C",100,100,0,40,26,0,0,26
"site C",100,100,0,40,27,0,0,27
"site C",100,100,0,42,26,0,0,26
"site C",100,100,0,41,25,0,0,25
"site C",100,100,0,40,27,0,0,27
"site C",100,100,0,41,27,0,0,27
"site C",100,100,0,40,26,0,0,26
"site C",100,100,0,40,28,0,0,28
"site C",100,100,0,41,26,0,0,26
"site C",100,100,0,41,27,0,0,27
"site C",100,100,0,41,26,0,0,26
"site C",100,100,0,43,25,0,0,25
"site C",100,100,0,40,26,0,0,26
"site C",100,100,0,42,24,0,0,24
"site C",100,100,0,40,26,0,0,26
"site C",100,100,0,42,27,0,0,27
"site C",100,100,0,41,31,0,0,31
"site C",100,100,0,41,27,0,0,27
"site C",100,100,0,42,26,0,0,26
"site C",100,100,0,42,26,0,0,26
"site C",100,100,0,41,28,0,0,28
"site C",100,100,0,41,26,0,0,26
"site C",100,100,0,42,27,0,0,27
"site C",100,100,0,41,26,0,0,26
"site C",100,100,0,42,27,0,0,27
"site C",100,100,0,42,26,0,0,26
"site C",100,100,0,41,28,0,0,28
"site C",100,100,0,41,26,0,0,26
"site C",100,100,0,42,29,0,0,29
"site C",100,100,0,41,27,0,0,27
"site C",100,100,0,41,27,0,0,27
"site C",100,100,0,42,26,0,0,26
"site C",100,100,0,41,25,0,0,25
"site C",100,100,0,40,26,0,0,26
"site C",100,100,0,41,27,0,0,27
"site C",100,100,0,41,26,0,0,26
"site D",0,0,298,0,0,105,193,105
"site D",0,0,295,0,0,104,191,104
"site D",0,0,287,0,0,103,184,103
"site D",0,0,288,0,0,102,186,102
"site D",0,0,293,0,0,102,191,102
"site D",0,0,287,0,0,102,185,102
"site D",0,0,290,0,0,103,187,103
"site D",0,0,293,0,0,104,189,104
"site D",0,0,284,0,0,102,182,102
"site D",0,0,285,0,0,102,183,102
"site D",0,0,292,0,0,105,187,105
"site D",0,0,290,0,0,103,187,103
"site D",0,0,285,0,0,103,182,103
"site D",0,0,285,0,0,102,183,102
"site D",0,0,293,0,0,104,189,104
"site D",0,0,293,0,0,104,189,104
"site D",0,0,292,0,0,104,188,104
"site D",0,0,288,0,0,102,186,102
"site D",0,0,296,0,0,105,191,105
"site D",0,0,295,0,0,103,192,103
"site D",0,0,290,0,0,104,186,104
"site D",0,0,286,0,0,104,182,104
"site D",0,0,292,0,0,105,187,105
"site D",0,0,291,0,0,103,188,103
"site D",0,0,291,0,0,104,187,104
"site D",0,0,290,0,0,104,186,104
"site D",0,0,293,0,0,103,190,103
"site D",0,0,289,0,0,101,188,101
"site D",0,0,294,0,0,105,189,105
"site D",0,0,290,0,0,103,187,103
"site D",0,0,296,0,0,104,192,104
"site D",0,0,297,0,0,104,193,104
"site D",0,0,289,0,0,105,184,105
"site D",0,0,292,0,0,105,187,105
"site D",0,0,297,0,0,107,190,107
"site D",0,0,290,0,0,104,186,104
"site D",0,0,284,0,0,103,181,103
"site D",0,0,286,0,0,99,187,99
"site D",0,0,291,0,0,103,188,103
"site D",0,0,289,0,0,103,186,103
"site D",0,25,258,0,25,74,184,99
"site D",0,25,248,0,25,72,176,97
"site D",0,25,257,0,25,72,185,97
"site D",0,25,258,0,25,74,184,99
"site D",0,25,256,0,25,74,182,99
"site D",0,25,254,0,25,73,181,98
"site D",0,25,247,0,25,73,174,98
"site D",0,25,248,0,25,74,174,99
"site D",0,25,258,0,25,73,185,98
"site D",0,25,261,0,25,74,187,99
"site D",0,25,259,0,25,74,185,99
"site D",0,25,254,0,25,74,180,99
"site D",0,25,255,0,25,74,181,99
"site D",0,25,256,0,26,74,182,100
"site D",0,25,254,0,25,73,181,98
"site D",0,25,257,0,24,73,184,97
"site D",0,25,261,0,25,73,188,98
"site D",0,25,254,0,25,73,181,98
"site D",0,25,250,0,25,72,178,97
"site D",0,25,256,0,25,74,182,99
"site D",0,25,253,0,26,74,179,100
"site D",0,25,254,0,25,74,180,99
"site D",0,25,252,0,25,72,180,97
"site D",0,25,251,0,25,72,179,97
"site D",0,25,253,0,25,73,180,98
"site D",0,25,249,0,25,73,176,98
"site D",0,25,257,0,25,75,182,100
"site D",0,25,257,0,25,73,184,98
"site D",0,25,255,0,25,74,181,99
"site D",0,25,253,0,25,73,180,98
"site D",0,25,254,0,25,72,182,97
"site D",0,25,256,0,25,72,184,97
"site D",0,25,254,0,24,73,181,97
"site D",0,25,259,0,25,74,185,99
"site D",0,25,254,0,25,74,180,99
"site D",0,25,258,0,25,72,186,97
"site D",0,25,262,0,26,75,187,101
"site D",0,25,259,0,25,73,186,98
"site D",0,25,262,0,25,73,189,98
"site D",0,25,253,0,25,73,180,98
"site D",0,50,217,0,48,46,171,94
"site D",0,50,226,0,49,47,179,96
"site D",0,50,217,0,47,47,170,94
"site D",0,50,219,0,48,47,172,95
"site D",0,50,219,0,46,45,174,91
"site D",0,50,228,0,48,48,180,96
"site D",0,50,219,0,46,46,173,92
"site D",0,50,229,0,48,47,182,95
"site D",0,50,221,0,48,47,174,95
"site D",0,50,217,0,46,45,172,91
"site D",0,50,222,0,46,45,177,91
"site D",0,50,219,0,46,46,173,92
"site D",0,50,221,0,46,46,175,92
"site D",0,50,223,0,46,45,178,91
"site D",0,50,224,0,46,46,178,92
"site D",0,50,221,0,48,47,174,95
"site D",0,50,220,0,48,47,173,95
"site D",0,50,227,0,48,47,180,95
"site D",0,50,218,0,47,46,172,93
"site D",0,50,223,0,46,46,177,92
"site D",0,50,223,0,48,47,176,95
"site D",0,50,219,0,47,46,173,93
"site D",0,50,221,0,48,46,175,94
"site D",0,50,221,0,47,46,175,93
"site D",0,50,220,0,47,46,174,93
"site D",0,50,223,0,47,45,178,92
"site D",0,50,217,0,47,46,171,93
"site D",0,50,223,0,46,44,179,90
"site D",0,50,222,0,47,45,177,92
"site D",0,50,226,0,48,48,178,96
"site D",0,50,219,0,46,46,173,92
"site D",0,50,223,0,47,47,176,94
"site D",0,50,219,0,48,47,172,95
"site D",0,50,220,0,46,44,176,90
"site D",0,50,221,0,48,47,174,95
"site D",0,50,231,0,48,48,183,96
"site D",0,50,222,0,47,46,176,93
"site D",0,50,217,0,46,45,172,91
"site D",0,50,221,0,49,47,174,96
"site D",0,50,224,0,46,46,178,92
"site D",0,75,189,0,64,20,169,84
"site D",0,75,187,0,59,19,168,78
"site D",0,75,199,0,64,21,178,85
"site D",0,75,191,0,64,20,171,84
"site D",0,75,193,0,64,21,172,85
"site D",0,75,192,0,63,20,172,83
"site D",0,75,190,0,63,21,169,84
"site D",0,75,188,0,63,20,168,83
"site D",0,75,190,0,67,23,167,90
"site D",0,75,193,0,67,22,171,89
"site D",0,75,193,0,63,21,172,84
"site D",0,75,193,0,67,23,170,90
"site D",0,75,193,0,67,22,171,89
"site D",0,75,185,0,64,20,165,84
"site D",0,75,188,0,64,21,167,85
"site D",0,75,194,0,65,22,172,87
"site D",0,75,198,0,67,22,176,89
"site D",0,75,190,0,65,21,169,86
"site D",0,75,195,0,64,22,173,86
"site D",0,75,194,0,65,21,173,86
"site D",0,75,189,0,63,20,169,83
"site D",0,75,195,0,68,22,173,90
"site D",0,75,191,0,67,22,169,89
"site D",0,75,188,0,62,20,168,82
"site D",0,75,184,0,60,19,165,79
"site D",0,75,190,0,64,22,168,86
"site D",0,75,190,0,63,20,170,83
"site D",0,75,191,0,63,20,171,83
"site D",0,75,191,0,61,19,172,80
"site D",0,75,192,0,65,22,170,87
"site D",0,75,194,0,69,23,171,92
"site D",0,75,197,0,61,21,176,82
"site D",0,75,191,0,69,23,168,92
"site D",0,75,189,0,65,22,167,87
"site D",0,75,192,0,64,21,171,85
"site D",0,75,193,0,69,23,170,92
"site D",0,75,190,0,61,20,170,81
"site D",0,75,191,0,67,22,169,89
"site D",0,75,190,0,64,21,169,85
"site D",0,75,199,0,67,23,176,90
"site D",0,100,161,0,74,0,161,74
"site D",0,100,170,0,77,0,170,77
"site D",0,100,167,0,76,0,167,76
"site D",0,100,169,0,78,0,169,78
"site D",0,100,165,0,76,0,165,76
"site D",0,100,165,0,77,0,165,77
"site D",0,100,160,0,75,0,160,75
"site D",0,100,171,0,80,0,171,80
"site D",0,100,169,0,76,0,169,76
"site D",0,100,167,0,76,0,167,76
"site D",0,100,169,0,76,0,169,76
"site D",0,100,164,0,75,0,164,75
"site D",0,100,169,0,77,0,169,77
"site D",0,100,163,0,76,0,163,76
"site D",0,100,170,0,78,0,170,78
"site D",0,100,159,0,75,0,159,75
"site D",0,100,170,0,76,0,170,76
"site D",0,100,171,0,78,0,171,78
"site D",0,100,167,0,77,0,167,77
"site D",0,100,173,0,76,0,173,76
"site D",0,100,163,0,75,0,163,75
"site D",0,100,167,0,77,0,167,77
"site D",0,100,171,0,78,0,171,78
"site D",0,100,169,0,75,0,169,75
"site D",0,100,167,0,78,0,167,78
"site D",0,100,168,0,77,0,168,77
"site D",0,100,168,0,78,0,168,78
"site D",0,100,167,0,77,0,167,77
"site D",0,100,167,0,76,0,167,76
"site D",0,100,163,0,75,0,163,75
"site D",0,100,166,0,75,0,166,75
"site D",0,100,169,0,78,0,169,78
"site D",0,100,167,0,77,0,167,77
"site D",0,100,161,0,76,0,161,76
"site D",0,100,173,0,76,0,173,76
"site D",0,100,165,0,75,0,165,75
"site D",0,100,169,0,77,0,169,77
"site D",0,100,167,0,78,0,167,78
"site D",0,100,161,0,76,0,161,76
"site D",0,100,163,0,75,0,163,75
"site D",25,0,197,37,0,87,110,87
"site D",25,0,199,38,0,87,112,87
"site D",25,0,211,40,0,94,117,94
"site D",25,0,203,37,0,92,111,92
"site D",25,0,200,37,0,91,109,91
"site D",25,0,204,37,0,92,112,92
"site D",25,0,202,38,0,92,110,92
"site D",25,0,205,39,0,89,116,89
"site D",25,0,207,40,0,90,117,90
"site D",25,0,202,37,0,89,113,89
"site D",25,0,203,39,0,89,114,89
"site D",25,0,211,39,0,92,119,92
"site D",25,0,213,39,0,95,118,95
"site D",25,0,206,37,0,94,112,94
"site D",25,0,211,40,0,93,118,93
"site D",25,0,214,40,0,93,121,93
"site D",25,0,200,36,0,90,110,90
"site D",25,0,206,39,0,92,114,92
"site D",25,0,212,39,0,95,117,95
"site D",25,0,207,40,0,90,117,90
"site D",25,0,201,38,0,90,111,90
"site D",25,0,211,39,0,94,117,94
"site D",25,0,203,37,0,92,111,92
"site D",25,0,209,39,0,95,114,95
"site D",25,0,200,38,0,88,112,88
"site D",25,0,203,38,0,93,110,93
"site D",25,0,207,38,0,96,111,96
"site D",25,0,201,37,0,90,111,90
"site D",25,0,206,38,0,92,114,92
"site D",25,0,207,39,0,91,116,91
"site D",25,0,208,38,0,95,113,95
"site D",25,0,202,38,0,89,113,89
"site D",25,0,210,39,0,92,118,92
"site D",25,0,200,37,0,92,108,92
"site D",25,0,198,37,0,91,107,91
"site D",25,0,208,39,0,93,115,93
"site D",25,0,202,38,0,89,113,89
"site D",25,0,207,38,0,93,114,93
"site D",25,0,204,38,0,91,113,91
"site D",25,0,208,39,0,94,114,94
"site D",25,25,170,37,21,63,107,84
"site D",25,25,169,37,21,61,108,82
"site D",25,25,166,35,21,61,105,82
"site D",25,25,172,36,22,65,107,87
"site D",25,25,171,37,21,60,111,81
"site D",25,25,169,37,21,61,108,82
"site D",25,25,180,39,21,62,118,83
"site D",25,25,166,36,21,61,105,82
"site D",25,25,165,36,20,58,107,78
"site D",25,25,168,35,22,62,106,84
"site D",25,25,166,36,20,59,107,79
"site D",25,25,169,36,21,62,107,83
"site D",25,25,172,37,21,62,110,83
"site D",25,25,175,38,21,64,111,85
"site D",25,25,174,38,21,62,112,83
"site D",25,25,179,38,22,67,112,89
"site D",25,25,170,36,20,60,110,80
"site D",25,25,168,36,21,61,107,82
"site D",25,25,174,37,21,62,112,83
"site D",25,25,168,37,20,59,109,79
"site D",25,25,174,38,21,61,113,82
"site D",25,25,170,37,21,61,109,82
"site D",25,25,170,36,21,62,108,83
"site D",25,25,170,37,21,61,109,82
"site D",25,25,169,36,20,60,109,80
"site D",25,25,172,37,21,62,110,83
"site D",25,25,172,37,21,62,110,83
"site D",25,25,170,38,21,60,110,81
"site D",25,25,176,39,21,61,115,82
"site D",25,25,161,35,21,59,102,80
"site D",25,25,167,35,20,62,105,82
"site D",25,25,170,37,21,59,111,80
"site D",25,25,171,37,21,62,109,83
"site D",25,25,168,36,21,62,106,83
"site D",25,25,177,39,21,63,114,84
"site D",25,25,172,37,21,62,110,83
"site D",25,25,172,37,21,62,110,83
"site D",25,25,173,38,22,63,110,85
"site D",25,25,169,36,21,61,108,82
"site D",25,25,173,37,21,62,111,83
"site D",25,50,140,35,38,37,103,75
"site D",25,50,138,35,37,36,102,73
"site D",25,50,141,36,38,37,104,75
"site D",25,50,146,36,40,40,106,80
"site D",25,50,141,35,39,39,102,78
"site D",25,50,140,34,39,37,103,76
"site D",25,50,140,35,38,36,104,74
"site D",25,50,141,35,38,37,104,75
"site D",25,50,141,36,38,36,105,74
"site D",25,50,139,35,39,37,102,76
"site D",25,50,141,35,39,37,104,76
"site D",25,50,142,36,39,38,104,77
"site D",25,50,148,36,40,39,109,79
"site D",25,50,142,36,38,37,105,75
"site D",25,50,139,35,38,37,102,75
"site D",25,50,139,35,37,35,104,72
"site D",25,50,141,34,39,37,104,76
"site D",25,50,143,35,40,38,105,78
"site D",25,50,144,36,37,36,108,73
"site D",25,50,142,35,38,38,104,76
"site D",25,50,141,36,37,37,104,74
"site D",25,50,142,35,39,39,103,78
"site D",25,50,139,35,39,37,102,76
"site D",25,50,148,37,38,37,111,75
"site D",25,50,145,36,39,38,107,77
"site D",25,50,148,37,39,39,109,78
"site D",25,50,145,35,40,40,105,80
"site D",25,50,142,35,39,38,104,77
"site D",25,50,143,36,38,37,106,75
"site D",25,50,141,35,39,39,102,78
"site D",25,50,142,35,38,38,104,76
"site D",25,50,142,35,38,37,105,75
"site D",25,50,142,35,38,36,106,74
"site D",25,50,141,35,38,37,104,75
"site D",25,50,150,38,39,39,111,78
"site D",25,50,145,36,40,39,106,79
"site D",25,50,138,35,36,35,103,71
"site D",25,50,146,36,39,39,107,78
"site D",25,50,138,35,37,36,102,73
"site D",25,50,144,35,39,38,106,77
"site D",25,75,119,34,55,18,101,73
"site D",25,75,116,34,53,18,98,71
"site D",25,75,122,35,54,17,105,71
"site D",25,75,121,35,50,16,105,66
"site D",25,75,118,34,50,16,102,66
"site D",25,75,120,35,51,16,104,67
"site D",25,75,122,35,54,18,104,72
"site D",25,75,122,35,54,18,104,72
"site D",25,75,123,36,53,17,106,70
"site D",25,75,117,34,48,16,101,64
"site D",25,75,118,35,50,16,102,66
"site D",25,75,117,33,53,18,99,71
"site D",25,75,113,33,50,16,97,66
"site D",25,75,122,35,54,18,104,72
"site D",25,75,119,34,54,17,102,71
"site D",25,75,113,33,52,17,96,69
"site D",25,75,122,35,53,17,105,70
"site D",25,75,117,33,53,18,99,71
"site D",25,75,119,34,52,17,102,69
"site D",25,75,124,36,55,18,106,73
"site D",25,75,117,33,51,17,100,68
"site D",25,75,115,34,50,17,98,67
"site D",25,75,123,36,53,17,106,70
"site D",25,75,115,33,52,17,98,69
"site D",25,75,114,34,49,16,98,65
"site D",25,75,122,36,49,16,106,65
"site D",25,75,125,36,53,18,107,71
"site D",25,75,114,33,52,16,98,68
"site D",25,75,120,35,52,17,103,69
"site D",25,75,116,34,52,18,98,70
"site D",25,75,122,34,54,18,104,72
"site D",25,75,119,35,53,17,102,70
"site D",25,75,118,33,53,18,100,71
"site D",25,75,124,36,54,17,107,71
"site D",25,75,119,35,54,17,102,71
"site D",25,75,119,35,49,16,103,65
"site D",25,75,122,35,52,16,106,68
"site D",25,75,120,35,52,18,102,70
"site D",25,75,119,34,53,18,101,71
"site D",25,75,117,35,50,16,101,66
"site D",25,100,99,33,62,0,99,62
"site D",25,100,105,35,64,0,105,64
"site D",25,100,98,33,61,0,98,61
"site D",25,100,96,33,57,0,96,57
"site D",25,100,99,34,61,0,99,61
"site D",25,100,95,32,64,0,95,64
"site D",25,100,98,33,60,0,98,60
"site D",25,100,103,35,65,0,103,65
"site D",25,100,98,33,63,0,98,63
"site D",25,100,99,33,63,0,99,63
"site D",25,100,101,34,62,0,101,62
"site D",25,100,105,36,65,0,105,65
"site D",25,100,98,33,63,0,98,63
"site D",25,100,98,34,64,0,98,64
"site D",25,100,99,34,62,0,99,62
"site D",25,100,100,34,63,0,100,63
"site D",25,100,96,32,63,0,96,63
"site D",25,100,97,33,62,0,97,62
"site D",25,100,95,32,62,0,95,62
"site D",25,100,101,34,65,0,101,65
"site D",25,100,103,35,67,0,103,67
"site D",25,100,97,33,62,0,97,62
"site D",25,100,100,34,59,0,100,59
"site D",25,100,100,33,63,0,100,63
"site D",25,100,97,32,62,0,97,62
"site D",25,100,100,34,65,0,100,65
"site D",25,100,97,33,63,0,97,63
"site D",25,100,98,33,63,0,98,63
"site D",25,100,96,32,64,0,96,64
"site D",25,100,97,32,60,0,97,60
"site D",25,100,100,34,65,0,100,65
"site D",25,100,102,34,61,0,102,61
"site D",25,100,96,33,63,0,96,63
"site D",25,100,104,34,65,0,104,65
"site D",25,100,103,35,65,0,103,65
"site D",25,100,95,33,62,0,95,62
"site D",25,100,104,35,62,0,104,62
"site D",25,100,102,34,63,0,102,63
"site D",25,100,101,34,64,0,101,64
"site D",25,100,97,33,64,0,97,64
"site D",50,0,140,61,0,79,61,79
"site D",50,0,134,60,0,76,58,76
"site D",50,0,135,60,0,76,59,76
"site D",50,0,139,60,0,80,59,80
"site D",50,0,133,60,0,75,58,75
"site D",50,0,131,57,0,75,56,75
"site D",50,0,130,57,0,75,55,75
"site D",50,0,131,58,0,74,57,74
"site D",50,0,139,60,0,80,59,80
"site D",50,0,136,59,0,77,59,77
"site D",50,0,132,57,0,76,56,76
"site D",50,0,130,57,0,74,56,74
"site D",50,0,132,58,0,75,57,75
"site D",50,0,140,62,0,78,62,78
"site D",50,0,142,62,0,80,62,80
"site D",50,0,134,56,0,79,55,79
"site D",50,0,137,63,0,76,61,76
"site D",50,0,139,60,0,80,59,80
"site D",50,0,137,60,0,79,58,79
"site D",50,0,138,62,0,77,61,77
"site D",50,0,134,59,0,77,57,77
"site D",50,0,135,60,0,76,59,76
"site D",50,0,134,59,0,76,58,76
"site D",50,0,133,59,0,76,57,76
"site D",50,0,131,59,0,74,57,74
"site D",50,0,133,59,0,75,58,75
"site D",50,0,130,57,0,75,55,75
"site D",50,0,135,60,0,76,59,76
"site D",50,0,133,59,0,75,58,75
"site D",50,0,142,63,0,80,62,80
"site D",50,0,135,58,0,78,57,78
"site D",50,0,132,58,0,76,56,76
"site D",50,0,137,60,0,78,59,78
"site D",50,0,127,55,0,72,55,72
"site D",50,0,138,60,0,78,60,78
"site D",50,0,130,57,0,75,55,75
"site D",50,0,137,60,0,79,58,79
"site D",50,0,139,61,0,79,60,79
"site D",50,0,143,63,0,82,61,82
"site D",50,0,136,58,0,80,56,80
"site D",50,25,108,55,18,53,55,71
"site D",50,25,107,54,18,53,54,71
"site D",50,25,111,58,18,53,58,71
"site D",50,25,112,60,18,52,60,70
"site D",50,25,104,57,16,49,55,65
"site D",50,25,107,56,18,53,54,71
"site D",50,25,109,61,17,50,59,67
"site D",50,25,109,59,16,50,59,66
"site D",50,25,107,59,17,49,58,66
"site D",50,25,105,56,18,50,55,68
"site D",50,25,107,60,17,48,59,65
"site D",50,25,104,54,18,51,53,69
"site D",50,25,106,57,17,50,56,67
"site D",50,25,105,57,16,48,57,64
"site D",50,25,105,54,18,52,53,70
"site D",50,25,113,58,19,55,58,74
"site D",50,25,107,57,17,50,57,67
"site D",50,25,112,58,19,56,56,75
"site D",50,25,104,54,18,51,53,69
"site D",50,25,109,59,18,50,59,68
"site D",50,25,111,60,18,52,59,70
"site D",50,25,109,55,19,55,54,74
"site D",50,25,110,57,18,53,57,71
"site D",50,25,109,58,18,51,58,69
"site D",50,25,103,54,17,50,53,67
"site D",50,25,107,54,19,53,54,72
"site D",50,25,111,58,19,54,57,73
"site D",50,25,108,58,18,51,57,69
"site D",50,25,105,56,17,50,55,67
"site D",50,25,106,55,18,53,53,71
"site D",50,25,109,58,18,52,57,70
"site D",50,25,106,57,17,50,56,67
"site D",50,25,107,56,18,51,56,69
"site D",50,25,112,59,18,54,58,72
"site D",50,25,107,54,18,54,53,72
"site D",50,25,112,61,18,52,60,70
"site D",50,25,101,55,16,47,54,63
"site D",50,25,106,54,18,52,54,70
"site D",50,25,108,58,18,51,57,69
"site D",50,25,109,60,18,50,59,68
"site D",50,50,84,56,30,29,55,59
"site D",50,50,81,53,29,29,52,58
"site D",50,50,86,55,33,31,55,64
"site D",50,50,86,56,32,31,55,63
"site D",50,50,79,54,28,26,53,54
"site D",50,50,87,58,31,30,57,61
"site D",50,50,79,53,30,28,51,58
"site D",50,50,89,57,32,32,57,64
"site D",50,50,86,56,32,31,55,63
"site D",50,50,84,56,31,30,54,61
"site D",50,50,85,54,32,31,54,63
"site D",50,50,87,57,32,31,56,63
"site D",50,50,85,56,30,30,55,60
"site D",50,50,89,58,32,32,57,64
"site D",50,50,82,53,30,29,53,59
"site D",50,50,86,57,32,30,56,62
"site D",50,50,82,52,30,30,52,60
"site D",50,50,84,56,31,30,54,61
"site D",50,50,82,53,32,30,52,62
"site D",50,50,85,55,33,32,53,65
"site D",50,50,91,60,33,32,59,65
"site D",50,50,81,53,31,29,52,60
"site D",50,50,86,56,32,30,56,62
"site D",50,50,86,57,32,30,56,62
"site D",50,50,83,52,32,31,52,63
"site D",50,50,80,52,29,29,51,58
"site D",50,50,81,53,30,29,52,59
"site D",50,50,83,53,31,30,53,61
"site D",50,50,82,52,31,31,51,62
"site D",50,50,83,54,31,30,53,61
"site D",50,50,80,51,31,30,50,61
"site D",50,50,84,55,30,29,55,59
"site D",50,50,85,56,32,30,55,62
"site D",50,50,84,55,31,30,54,61
"site D",50,50,82,53,30,30,52,60
"site D",50,50,83,56,30,28,55,58
"site D",50,50,81,53,30,29,52,59
"site D",50,50,84,55,32,30,54,62
"site D",50,50,83,54,31,30,53,61
"site D",50,50,88,59,31,30,58,61
"site D",50,75,64,52,41,13,51,54
"site D",50,75,68,54,44,15,53,59
"site D",50,75,66,52,40,14,52,54
"site D",50,75,67,53,43,14,53,57
"site D",50,75,61,50,40,12,49,52
"site D",50,75,64,52,38,12,52,50
"site D",50,75,67,53,42,14,53,56
"site D",50,75,62,51,38,12,50,50
"site D",50,75,62,51,40,12,50,52
"site D",50,75,68,56,39,13,55,52
"site D",50,75,66,53,42,14,52,56
"site D",50,75,63,51,39,13,50,52
"site D",50,75,65,54,37,12,53,49
"site D",50,75,67,54,40,14,53,54
"site D",50,75,68,57,41,13,55,54
"site D",50,75,65,54,37,12,53,49
"site D",50,75,64,52,40,12,52,52
"site D",50,75,67,55,42,14,53,56
"site D",50,75,65,52,40,13,52,53
"site D",50,75,65,52,42,13,52,55
"site D",50,75,65,52,37,13,52,50
"site D",50,75,66,54,39,13,53,52
"site D",50,75,63,52,36,12,51,48
"site D",50,75,64,52,40,13,51,53
"site D",50,75,64,52,42,14,50,56
"site D",50,75,63,52,36,12,51,48
"site D",50,75,65,54,39,12,53,51
"site D",50,75,65,51,42,14,51,56
"site D",50,75,64,52,37,13,51,50
"site D",50,75,66,55,42,13,53,55
"site D",50,75,63,52,37,13,50,50
"site D",50,75,65,55,38,12,53,50
"site D",50,75,67,54,45,14,53,59
"site D",50,75,64,50,43,14,50,57
"site D",50,75,67,55,40,14,53,54
"site D",50,75,60,49,36,12,48,48
"site D",50,75,62,50,38,13,49,51
"site D",50,75,65,53,43,13,52,56
"site D",50,75,63,51,37,13,50,50
"site D",50,75,65,54,41,13,52,54
"site D",50,100,48,49,43,0,48,43
"site D",50,100,50,51,45,0,50,45
"site D",50,100,47,49,44,0,47,44
"site D",50,100,48,48,43,0,48,43
"site D",50,100,52,52,45,0,52,45
"site D",50,100,50,51,48,0,50,48
"site D",50,100,51,52,43,0,51,43
"site D",50,100,49,50,44,0,49,44
"site D",50,100,51,52,45,0,51,45
"site D",50,100,52,53,45,0,52,45
"site D",50,100,48,49,45,0,48,45
"site D",50,100,51,52,46,0,51,46
"site D",50,100,48,49,41,0,48,41
"site D",50,100,48,50,42,0,48,42
"site D",50,100,49,51,51,0,49,51
"site D",50,100,50,50,44,0,50,44
"site D",50,100,52,53,46,0,52,46
"site D",50,100,52,52,45,0,52,45
"site D",50,100,50,52,51,0,50,51
"site D",50,100,51,53,44,0,51,44
"site D",50,100,50,51,42,0,50,42
"site D",50,100,50,52,39,0,50,39
"site D",50,100,48,49,49,0,48,49
"site D",50,100,50,52,43,0,50,43
"site D",50,100,50,51,43,0,50,43
"site D",50,100,51,51,49,0,51,49
"site D",50,100,51,53,40,0,51,40
"site D",50,100,49,49,39,0,49,39
"site D",50,100,53,53,48,0,53,48
"site D",50,100,47,49,43,0,47,43
"site D",50,100,50,50,43,0,50,43
"site D",50,100,49,50,46,0,49,46
"site D",50,100,54,54,50,0,54,50
"site D",50,100,49,51,46,0,49,46
"site D",50,100,51,51,49,0,51,49
"site D",50,100,51,52,43,0,51,43
"site D",50,100,50,51,45,0,50,45
"site D",50,100,46,47,46,0,46,46
"site D",50,100,50,51,52,0,50,52
"site D",50,100,50,52,45,0,50,45
"site D",75,0,82,65,0,61,21,61
"site D",75,0,79,64,0,59,20,59
"site D",75,0,80,61,0,60,20,60
"site D",75,0,84,66,0,62,22,62
"site D",75,0,84,67,0,62,22,62
"site D",75,0,86,67,0,65,21,65
"site D",75,0,83,66,0,62,21,62
"site D",75,0,85,61,0,64,21,64
"site D",75,0,82,67,0,59,23,59
"site D",75,0,84,66,0,62,22,62
"site D",75,0,84,64,0,63,21,63
"site D",75,0,86,68,0,63,23,63
"site D",75,0,82,68,0,59,23,59
"site D",75,0,83,70,0,60,23,60
"site D",75,0,81,64,0,60,21,60
"site D",75,0,85,67,0,63,22,63
"site D",75,0,85,67,0,63,22,63
"site D",75,0,84,67,0,62,22,62
"site D",75,0,83,66,0,61,22,61
"site D",75,0,76,64,0,55,21,55
"site D",75,0,82,64,0,60,22,60
"site D",75,0,85,69,0,63,22,63
"site D",75,0,86,67,0,64,22,64
"site D",75,0,80,66,0,58,22,58
"site D",75,0,85,69,0,62,23,62
"site D",75,0,85,62,0,64,21,64
"site D",75,0,84,68,0,62,22,62
"site D",75,0,87,66,0,65,22,65
"site D",75,0,83,64,0,63,20,63
"site D",75,0,84,69,0,61,23,61
"site D",75,0,84,66,0,62,22,62
"site D",75,0,82,65,0,61,21,61
"site D",75,0,86,66,0,64,22,64
"site D",75,0,82,61,0,63,19,63
"site D",75,0,82,66,0,60,22,60
"site D",75,0,85,66,0,64,21,64
"site D",75,0,79,61,0,58,21,58
"site D",75,0,83,67,0,61,22,61
"site D",75,0,88,62,0,67,21,67
"site D",75,0,81,67,0,59,22,59
"site D",75,25,58,62,12,38,20,50
"site D",75,25,59,64,14,39,20,53
"site D",75,25,63,64,14,41,22,55
"site D",75,25,58,60,14,38,20,52
"site D",75,25,62,67,14,39,23,53
"site D",75,25,61,61,13,41,20,54
"site D",75,25,59,64,13,38,21,51
"site D",75,25,59,60,13,40,19,53
"site D",75,25,59,60,14,39,20,53
"site D",75,25,60,64,13,38,22,51
"site D",75,25,65,71,15,42,23,57
"site D",75,25,60,62,14,40,20,54
"site D",75,25,61,62,14,41,20,55
"site D",75,25,59,65,13,38,21,51
"site D",75,25,59,62,13,39,20,52
"site D",75,25,59,66,13,37,22,50
"site D",75,25,57,63,13,37,20,50
"site D",75,25,60,63,14,39,21,53
"site D",75,25,61,65,14,39,22,53
"site D",75,25,57,65,13,36,21,49
"site D",75,25,58,62,14,38,20,52
"site D",75,25,58,61,13,38,20,51
"site D",75,25,62,67,14,40,22,54
"site D",75,25,57,57,13,38,19,51
"site D",75,25,65,66,14,43,22,57
"site D",75,25,60,64,14,39,21,53
"site D",75,25,63,66,14,41,22,55
"site D",75,25,56,61,13,36,20,49
"site D",75,25,56,63,13,36,20,49
"site D",75,25,59,65,14,38,21,52
"site D",75,25,59,63,14,39,20,53
"site D",75,25,63,64,14,41,22,55
"site D",75,25,59,63,14,38,21,52
"site D",75,25,59,64,14,39,20,53
"site D",75,25,64,63,15,43,21,58
"site D",75,25,63,67,14,41,22,55
"site D",75,25,63,65,14,42,21,56
"site D",75,25,60,66,13,38,22,51
"site D",75,25,61,66,14,40,21,54
"site D",75,25,58,60,14,39,19,53
"site D",75,50,42,63,23,22,20,45
"site D",75,50,41,63,23,21,20,44
"site D",75,50,43,63,22,22,21,44
"site D",75,50,44,62,25,24,20,49
"site D",75,50,39,62,19,19,20,38
"site D",75,50,40,59,22,21,19,43
"site D",75,50,40,61,22,20,20,42
"site D",75,50,43,61,24,23,20,47
"site D",75,50,41,61,21,21,20,42
"site D",75,50,41,63,22,21,20,43
"site D",75,50,40,61,22,20,20,42
"site D",75,50,44,65,24,22,22,46
"site D",75,50,41,60,22,21,20,43
"site D",75,50,39,61,21,20,19,41
"site D",75,50,42,61,23,22,20,45
"site D",75,50,40,60,22,21,19,43
"site D",75,50,37,58,19,19,18,38
"site D",75,50,40,59,21,21,19,42
"site D",75,50,44,63,23,23,21,46
"site D",75,50,40,64,21,20,20,41
"site D",75,50,40,62,21,20,20,41
"site D",75,50,40,60,22,20,20,42
"site D",75,50,40,62,21,20,20,41
"site D",75,50,41,64,22,21,20,43
"site D",75,50,42,63,23,21,21,44
"site D",75,50,40,61,21,19,21,40
"site D",75,50,38,64,19,18,20,37
"site D",75,50,46,69,24,23,23,47
"site D",75,50,42,70,21,20,22,41
"site D",75,50,42,62,22,21,21,43
"site D",75,50,41,58,24,22,19,46
"site D",75,50,38,58,19,19,19,38
"site D",75,50,42,60,23,22,20,45
"site D",75,50,42,61,22,22,20,44
"site D",75,50,40,59,22,21,19,43
"site D",75,50,41,62,21,21,20,42
"site D",75,50,43,62,23,22,21,45
"site D",75,50,43,63,24,22,21,46
"site D",75,50,39,59,21,20,19,41
"site D",75,50,41,62,22,20,21,42
"site D",75,75,26,57,25,8,18,33
"site D",75,75,28,59,26,8,20,34
"site D",75,75,25,56,22,7,18,29
"site D",75,75,27,57,25,9,18,34
"site D",75,75,29,59,29,9,20,38
"site D",75,75,29,59,27,9,20,36
"site D",75,75,29,62,27,8,21,35
"site D",75,75,29,60,27,9,20,36
"site D",75,75,29,58,28,10,19,38
"site D",75,75,28,60,25,8,20,33
"site D",75,75,28,61,26,9,19,35
"site D",75,75,28,61,25,8,20,33
"site D",75,75,29,58,28,9,20,37
"site D",75,75,30,59,29,10,20,39
"site D",75,75,27,62,20,6,21,26
"site D",75,75,27,59,25,8,19,33
"site D",75,75,27,60,24,8,19,32
"site D",75,75,26,58,23,7,19,30
"site D",75,75,31,61,28,10,21,38
"site D",75,75,25,59,22,6,19,28
"site D",75,75,25,55,22,7,18,29
"site D",75,75,28,59,27,8,20,35
"site D",75,75,30,62,27,9,21,36
"site D",75,75,24,58,22,6,18,28
"site D",75,75,26,60,24,7,19,31
"site D",75,75,30,59,28,10,20,38
"site D",75,75,27,58,25,8,19,33
"site D",75,75,31,63,30,10,21,40
"site D",75,75,27,58,26,9,18,35
"site D",75,75,28,59,25,9,19,34
"site D",75,75,28,60,25,8,20,33
"site D",75,75,28,58,28,9,19,37
"site D",75,75,27,59,25,7,20,32
"site D",75,75,27,59,25,8,19,33
"site D",75,75,30,62,28,9,21,37
"site D",75,75,30,62,28,10,20,38
"site D",75,75,28,60,26,8,20,34
"site D",75,75,27,57,27,8,19,35
"site D",75,75,30,61,27,9,21,36
"site D",75,75,30,60,28,10,20,38
"site D",75,100,19,56,23,0,19,23
"site D",75,100,20,60,22,0,20,22
"site D",75,100,21,63,23,0,21,23
"site D",75,100,18,56,24,0,18,24
"site D",75,100,18,58,25,0,18,25
"site D",75,100,18,56,24,0,18,24
"site D",75,100,19,58,27,0,19,27
"site D",75,100,19,58,23,0,19,23
"site D",75,100,20,60,23,0,20,23
"site D",75,100,18,57,26,0,18,26
"site D",75,100,20,58,23,0,20,23
"site D",75,100,19,58,24,0,19,24
"site D",75,100,18,56,23,0,18,23
"site D",75,100,18,58,24,0,18,24
"site D",75,100,19,59,23,0,19,23
"site D",75,100,18,55,24,0,18,24
"site D",75,100,18,56,22,0,18,22
"site D",75,100,18,54,21,0,18,21
"site D",75,100,18,58,23,0,18,23
"site D",75,100,20,60,24,0,20,24
"site D",75,100,19,57,23,0,19,23
"site D",75,100,18,58,24,0,18,24
"site D",75,100,19,57,25,0,19,25
"site D",75,100,20,61,28,0,20,28
"site D",75,100,18,55,22,0,18,22
"site D",75,100,18,55,22,0,18,22
"site D",75,100,18,55,25,0,18,25
"site D",75,100,19,58,23,0,19,23
"site D",75,100,18,58,24,0,18,24
"site D",75,100,19,58,24,0,19,24
"site D",75,100,19,59,26,0,19,26
"site D",75,100,18,56,24,0,18,24
"site D",75,100,19,58,23,0,19,23
"site D",75,100,18,54,24,0,18,24
"site D",75,100,17,54,25,0,17,25
"site D",75,100,20,59,25,0,20,25
"site D",75,100,19,57,24,0,19,24
"site D",75,100,18,58,24,0,18,24
"site D",75,100,19,60,24,0,19,24
"site D",75,100,20,59,24,0,20,24
"site D",100,0,49,71,0,49,0,49
"site D",100,0,46,70,0,46,0,46
"site D",100,0,48,72,0,48,0,48
"site D",100,0,50,72,0,50,0,50
"site D",100,0,46,71,0,46,0,46
"site D",100,0,49,73,0,49,0,49
"site D",100,0,52,72,0,52,0,52
"site D",100,0,48,69,0,48,0,48
"site D",100,0,48,71,0,48,0,48
"site D",100,0,49,70,0,49,0,49
"site D",100,0,50,71,0,50,0,50
"site D",100,0,49,71,0,49,0,49
"site D",100,0,51,73,0,51,0,51
"site D",100,0,49,70,0,49,0,49
"site D",100,0,51,70,0,51,0,51
"site D",100,0,48,70,0,48,0,48
"site D",100,0,46,71,0,46,0,46
"site D",100,0,50,73,0,50,0,50
"site D",100,0,46,70,0,46,0,46
"site D",100,0,50,69,0,50,0,50
"site D",100,0,47,72,0,47,0,47
"site D",100,0,49,72,0,49,0,49
"site D",100,0,50,69,0,50,0,50
"site D",100,0,49,71,0,49,0,49
"site D",100,0,51,73,0,51,0,51
"site D",100,0,49,71,0,49,0,49
"site D",100,0,51,70,0,51,0,51
"site D",100,0,46,71,0,46,0,46
"site D",100,0,48,74,0,48,0,48
"site D",100,0,51,71,0,51,0,51
"site D",100,0,50,68,0,50,0,50
"site D",100,0,47,71,0,47,0,47
"site D",100,0,48,73,0,48,0,48
"site D",100,0,47,72,0,47,0,47
"site D",100,0,51,72,0,51,0,51
"site D",100,0,49,70,0,49,0,49
"site D",100,0,48,70,0,48,0,48
"site D",100,0,50,72,0,50,0,50
"site D",100,0,51,70,0,51,0,51
"site D",100,0,49,72,0,49,0,49
"site D",100,25,31,75,10,31,0,41
"site D",100,25,31,70,11,31,0,42
"site D",100,25,27,70,9,27,0,36
"site D",100,25,30,71,11,30,0,41
"site D",100,25,29,71,9,29,0,38
"site D",100,25,26,72,9,26,0,35
"site D",100,25,29,70,10,29,0,39
"site D",100,25,27,69,10,27,0,37
"site D",100,25,30,69,10,30,0,40
"site D",100,25,31,72,11,31,0,42
"site D",100,25,28,70,10,28,0,38
"site D",100,25,29,69,10,29,0,39
"site D",100,25,29,72,10,29,0,39
"site D",100,25,29,71,9,29,0,38
"site D",100,25,29,70,10,29,0,39
"site D",100,25,29,70,10,29,0,39
"site D",100,25,26,71,10,26,0,36
"site D",100,25,26,71,10,26,0,36
"site D",100,25,29,69,10,29,0,39
"site D",100,25,29,71,10,29,0,39
"site D",100,25,26,72,10,26,0,36
"site D",100,25,29,71,11,29,0,40
"site D",100,25,27,70,10,27,0,37
"site D",100,25,28,72,10,28,0,38
"site D",100,25,29,71,11,29,0,40
"site D",100,25,30,71,11,30,0,41
"site D",100,25,29,71,10,29,0,39
"site D",100,25,28,71,9,28,0,37
"site D",100,25,28,69,10,28,0,38
"site D",100,25,29,72,11,29,0,40
"site D",100,25,27,72,10,27,0,37
"site D",100,25,29,74,9,29,0,38
"site D",100,25,26,71,10,26,0,36
"site D",100,25,29,71,10,29,0,39
"site D",100,25,28,70,9,28,0,37
"site D",100,25,30,69,11,30,0,41
"site D",100,25,30,72,11,30,0,41
"site D",100,25,26,69,10,26,0,36
"site D",100,25,29,72,11,29,0,40
"site D",100,25,32,71,10,32,0,42
"site D",100,50,13,72,15,13,0,28
"site D",100,50,14,72,15,14,0,29
"site D",100,50,14,72,16,14,0,30
"site D",100,50,15,71,17,15,0,32
"site D",100,50,16,70,17,16,0,33
"site D",100,50,14,70,15,14,0,29
"site D",100,50,14,71,15,14,0,29
"site D",100,50,16,70,16,16,0,32
"site D",100,50,14,71,15,14,0,29
"site D",100,50,14,71,15,14,0,29
"site D",100,50,15,70,16,15,0,31
"site D",100,50,14,71,14,14,0,28
"site D",100,50,15,72,16,15,0,31
"site D",100,50,14,71,14,14,0,28
"site D",100,50,16,70,17,16,0,33
"site D",100,50,11,71,13,11,0,24
"site D",100,50,14,71,15,14,0,29
"site D",100,50,15,70,15,15,0,30
"site D",100,50,15,70,17,15,0,32
"site D",100,50,15,71,15,15,0,30
"site D",100,50,17,72,18,17,0,35
"site D",100,50,14,71,15,14,0,29
"site D",100,50,15,72,16,15,0,31
"site D",100,50,16,69,17,16,0,33
"site D",100,50,16,70,18,16,0,34
"site D",100,50,13,71,15,13,0,28
"site D",100,50,16,70,17,16,0,33
"site D",100,50,15,70,16,15,0,31
"site D",100,50,14,70,16,14,0,30
"site D",100,50,14,68,16,14,0,30
"site D",100,50,13,71,15,13,0,28
"site D",100,50,13,71,15,13,0,28
"site D",100,50,16,71,17,16,0,33
"site D",100,50,14,70,16,14,0,30
"site D",100,50,16,69,16,16,0,32
"site D",100,50,12,71,14,12,0,26
"site D",100,50,14,70,16,14,0,30
"site D",100,50,14,70,16,14,0,30
"site D",100,50,16,70,17,16,0,33
"site D",100,50,15,71,16,15,0,31
"site D",100,75,5,70,17,5,0,22
"site D",100,75,5,70,17,5,0,22
"site D",100,75,6,72,20,6,0,26
"site D",100,75,6,73,18,6,0,24
"site D",100,75,5,69,17,5,0,22
"site D",100,75,6,72,19,6,0,25
"site D",100,75,5,71,17,5,0,22
"site D",100,75,7,70,19,7,0,26
"site D",100,75,6,72,18,6,0,24
"site D",100,75,6,70,18,6,0,24
"site D",100,75,6,69,18,6,0,24
"site D",100,75,6,73,18,6,0,24
"site D",100,75,5,69,16,5,0,21
"site D",100,75,5,71,17,5,0,22
"site D",100,75,6,72,20,6,0,26
"site D",100,75,6,70,18,6,0,24
"site D",100,75,6,71,17,6,0,23
"site D",100,75,6,71,19,6,0,25
"site D",100,75,6,70,17,6,0,23
"site D",100,75,5,71,17,5,0,22
"site D",100,75,5,72,19,5,0,24
"site D",100,75,5,70,19,5,0,24
"site D",100,75,5,71,16,5,0,21
"site D",100,75,6,70,19,6,0,25
"site D",100,75,5,70,16,5,0,21
"site D",100,75,6,71,17,6,0,23
"site D",100,75,5,70,19,5,0,24
"site D",100,75,6,70,18,6,0,24
"site D",100,75,6,72,18,6,0,24
"site D",100,75,5,72,18,5,0,23
"site D",100,75,7,70,19,7,0,26
"site D",100,75,7,70,19,7,0,26
"site D",100,75,6,71,19,6,0,25
"site D",100,75,5,69,17,5,0,22
"site D",100,75,6,71,18,6,0,24
"site D",100,75,7,70,19,7,0,26
"site D",100,75,7,69,19,7,0,26
"site D",100,75,5,71,19,5,0,24
"site D",100,75,5,68,17,5,0,22
"site D",100,75,6,70,18,6,0,24
"site D",100,100,0,70,22,0,0,22
"site D",100,100,0,71,21,0,0,21
"site D",100,100,0,71,21,0,0,21
"site D",100,100,0,69,22,0,0,22
"site D",100,100,0,70,22,0,0,22
"site D",100,100,0,70,23,0,0,23
"site D",100,100,0,71,21,0,0,21
"site D",100,100,0,71,21,0,0,21
"site D",100,100,0,70,23,0,0,23
"site D",100,100,0,69,22,0,0,22
"site D",100,100,0,72,23,0,0,23
"site D",100,100,0,70,24,0,0,24
"site D",100,100,0,71,24,0,0,24
"site D",100,100,0,72,23,0,0,23
"site D",100,100,0,71,22,0,0,22
"site D",100,100,0,69,21,0,0,21
"site D",100,100,0,68,22,0,0,22
"site D",100,100,0,70,22,0,0,22
"site D",100,100,0,69,22,0,0,22
"site D",100,100,0,69,23,0,0,23
"site D",100,100,0,71,23,0,0,23
"site D",100,100,0,70,22,0,0,22
"site D",100,100,0,72,21,0,0,21
"site D",100,100,0,72,23,0,0,23
"site D",100,100,0,71,23,0,0,23
"site D",100,100,0,70,23,0,0,23
"site D",100,100,0,72,22,0,0,22
"site D",100,100,0,71,22,0,0,22
"site D",100,100,0,68,22,0,0,22
"site D",100,100,0,72,23,0,0,23
"site D",100,100,0,70,23,0,0,23
"site D",100,100,0,72,23,0,0,23
"site D",100,100,0,70,22,0,0,22
"site D",100,100,0,70,21,0,0,21
"site D",100,100,0,70,22,0,0,22
"site D",100,100,0,71,22,0,0,22
"site D",100,100,0,70,21,0,0,21
"site D",100,100,0,71,23,0,0,23
"site D",100,100,0,72,22,0,0,22
"site D",100,100,0,71,23,0,0,23
"site E",0,0,333,0,0,21,312,21
"site E",0,0,328,0,0,21,307,21
"site E",0,0,334,0,0,21,313,21
"site E",0,0,328,0,0,20,308,20
"site E",0,0,338,0,0,23,315,23
"site E",0,0,332,0,0,23,309,23
"site E",0,0,333,0,0,23,310,23
"site E",0,0,337,0,0,22,315,22
"site E",0,0,339,0,0,23,316,23
"site E",0,0,337,0,0,24,313,24
"site E",0,0,337,0,0,21,316,21
"site E",0,0,338,0,0,20,318,20
"site E",0,0,338,0,0,21,317,21
"site E",0,0,334,0,0,21,313,21
"site E",0,0,330,0,0,22,308,22
"site E",0,0,336,0,0,23,313,23
"site E",0,0,330,0,0,23,307,23
"site E",0,0,334,0,0,21,313,21
"site E",0,0,332,0,0,22,310,22
"site E",0,0,337,0,0,22,315,22
"site E",0,0,332,0,0,22,310,22
"site E",0,0,334,0,0,20,314,20
"site E",0,0,332,0,0,20,312,20
"site E",0,0,339,0,0,23,316,23
"site E",0,0,344,0,0,24,320,24
"site E",0,0,338,0,0,20,318,20
"site E",0,0,335,0,0,21,314,21
"site E",0,0,329,0,0,21,308,21
"site E",0,0,345,0,0,25,320,25
"site E",0,0,335,0,0,21,314,21
"site E",0,0,332,0,0,21,311,21
"site E",0,0,333,0,0,23,310,23
"site E",0,0,330,0,0,22,308,22
"site E",0,0,338,0,0,21,317,21
"site E",0,0,338,0,0,22,316,22
"site E",0,0,338,0,0,23,315,23
"site E",0,0,334,0,0,23,311,23
"site E",0,0,332,0,0,21,311,21
"site E",0,0,334,0,0,20,314,20
"site E",0,0,334,0,0,23,311,23
"site E",0,25,327,0,6,16,311,22
"site E",0,25,330,0,6,16,314,22
"site E",0,25,332,0,5,15,317,20
"site E",0,25,331,0,6,16,315,22
"site E",0,25,333,0,5,15,318,20
"site E",0,25,331,0,6,17,314,23
"site E",0,25,316,0,5,15,301,20
"site E",0,25,327,0,5,16,311,21
"site E",0,25,330,0,6,17,313,23
"site E",0,25,327,0,5,16,311,21
"site E",0,25,328,0,5,15,313,20
"site E",0,25,328,0,5,17,311,22
"site E",0,25,328,0,6,18,310,24
"site E",0,25,336,0,6,17,319,23
"site E",0,25,327,0,6,16,311,22
"site E",0,25,333,0,6,16,317,22
"site E",0,25,327,0,5,16,311,21
"site E",0,25,328,0,6,17,311,23
"site E",0,25,329,0,5,15,314,20
"site E",0,25,326,0,5,15,311,20
"site E",0,25,333,0,5,15,318,20
"site E",0,25,325,0,5,15,310,20
"site E",0,25,326,0,5,16,310,21
"site E",0,25,334,0,6,16,318,22
"site E",0,25,332,0,5,16,316,21
"site E",0,25,329,0,6,16,313,22
"site E",0,25,331,0,5,16,315,21
"site E",0,25,332,0,5,16,316,21
"site E",0,25,334,0,5,16,318,21
"site E",0,25,325,0,6,16,309,22
"site E",0,25,323,0,5,16,307,21
"site E",0,25,334,0,6,16,318,22
"site E",0,25,329,0,6,16,313,22
"site E",0,25,328,0,5,15,313,20
"site E",0,25,323,0,5,15,308,20
"site E",0,25,333,0,5,16,317,21
"site E",0,25,325,0,6,16,309,22
"site E",0,25,331,0,6,16,315,22
"site E",0,25,326,0,6,17,309,23
"site E",0,25,334,0,6,19,315,25
"site E",0,50,320,0,11,10,310,21
"site E",0,50,324,0,11,10,314,21
"site E",0,50,325,0,12,11,314,23
"site E",0,50,316,0,11,10,306,21
"site E",0,50,321,0,11,10,311,21
"site E",0,50,317,0,11,10,307,21
"site E",0,50,323,0,11,10,313,21
"site E",0,50,324,0,12,11,313,23
"site E",0,50,323,0,11,10,313,21
"site E",0,50,323,0,11,10,313,21
"site E",0,50,320,0,12,11,309,23
"site E",0,50,318,0,11,11,307,22
"site E",0,50,322,0,11,10,312,21
"site E",0,50,320,0,11,11,309,22
"site E",0,50,324,0,11,10,314,21
"site E",0,50,322,0,13,11,311,24
"site E",0,50,322,0,11,10,312,21
"site E",0,50,318,0,10,10,308,20
"site E",0,50,327,0,11,11,316,22
"site E",0,50,324,0,11,10,314,21
"site E",0,50,324,0,12,11,313,23
"site E",0,50,328,0,11,11,317,22
"site E",0,50,330,0,10,10,320,20
"site E",0,50,326,0,12,11,315,23
"site E",0,50,324,0,12,10,314,22
"site E",0,50,323,0,11,11,312,22
"site E",0,50,323,0,11,10,313,21
"site E",0,50,325,0,10,10,315,20
"site E",0,50,318,0,12,11,307,23
"site E",0,50,331,0,11,11,320,22
"site E",0,50,326,0,12,10,316,22
"site E",0,50,320,0,10,10,310,20
"site E",0,50,335,0,12,11,324,23
"site E",0,50,324,0,11,11,313,22
"site E",0,50,322,0,12,11,311,23
"site E",0,50,326,0,11,11,315,22
"site E",0,50,322,0,11,10,312,21
"site E",0,50,327,0,11,10,317,21
"site E",0,50,327,0,11,11,316,22
"site E",0,50,321,0,10,10,311,20
"site E",0,75,322,0,17,6,316,23
"site E",0,75,320,0,15,5,315,20
"site E",0,75,317,0,16,5,312,21
"site E",0,75,316,0,18,5,311,23
"site E",0,75,317,0,17,5,312,22
"site E",0,75,325,0,17,6,319,23
"site E",0,75,325,0,17,6,319,23
"site E",0,75,319,0,16,5,314,21
"site E",0,75,323,0,17,5,318,22
"site E",0,75,321,0,17,5,316,22
"site E",0,75,315,0,16,5,310,21
"site E",0,75,315,0,17,5,310,22
"site E",0,75,321,0,17,5,316,22
"site E",0,75,319,0,16,5,314,21
"site E",0,75,317,0,16,5,312,21
"site E",0,75,326,0,15,5,321,20
"site E",0,75,321,0,14,5,316,19
"site E",0,75,321,0,16,5,316,21
"site E",0,75,322,0,17,6,316,23
"site E",0,75,315,0,17,6,309,23
"site E",0,75,312,0,15,5,307,20
"site E",0,75,323,0,18,6,317,24
"site E",0,75,320,0,17,5,315,22
"site E",0,75,321,0,15,5,316,20
"site E",0,75,316,0,17,5,311,22
"site E",0,75,314,0,16,5,309,21
"site E",0,75,319,0,16,5,314,21
"site E",0,75,312,0,19,6,306,25
"site E",0,75,315,0,17,5,310,22
"site E",0,75,320,0,16,5,315,21
"site E",0,75,318,0,15,5,313,20
"site E",0,75,317,0,17,6,311,23
"site E",0,75,315,0,17,5,310,22
"site E",0,75,315,0,15,5,310,20
"site E",0,75,317,0,17,5,312,22
"site E",0,75,315,0,15,5,310,20
"site E",0,75,316,0,17,5,311,22
"site E",0,75,321,0,16,5,316,21
"site E",0,75,317,0,16,5,312,21
"site E",0,75,315,0,18,5,310,23
"site E",0,100,311,0,22,0,311,22
"site E",0,100,311,0,23,0,311,23
"site E",0,100,315,0,20,0,315,20
"site E",0,100,317,0,23,0,317,23
"site E",0,100,313,0,21,0,313,21
"site E",0,100,313,0,21,0,313,21
"site E",0,100,313,0,22,0,313,22
"site E",0,100,314,0,20,0,314,20
"site E",0,100,309,0,20,0,309,20
"site E",0,100,317,0,21,0,317,21
"site E",0,100,315,0,22,0,315,22
"site E",0,100,312,0,22,0,312,22
"site E",0,100,320,0,21,0,320,21
"site E",0,100,312,0,23,0,312,23
"site E",0,100,316,0,20,0,316,20
"site E",0,100,311,0,21,0,311,21
"site E",0,100,310,0,21,0,310,21
"site E",0,100,316,0,22,0,316,22
"site E",0,100,314,0,24,0,314,24
"site E",0,100,310,0,21,0,310,21
"site E",0,100,311,0,21,0,311,21
"site E",0,100,314,0,20,0,314,20
"site E",0,100,309,0,20,0,309,20
"site E",0,100,316,0,22,0,316,22
"site E",0,100,315,0,21,0,315,21
"site E",0,100,312,0,21,0,312,21
"site E",0,100,317,0,23,0,317,23
"site E",0,100,316,0,22,0,316,22
"site E",0,100,312,0,22,0,312,22
"site E",0,100,313,0,22,0,313,22
"site E",0,100,312,0,23,0,312,23
"site E",0,100,311,0,21,0,311,21
"site E",0,100,312,0,21,0,312,21
"site E",0,100,314,0,23,0,314,23
"site E",0,100,312,0,22,0,312,22
"site E",0,100,313,0,22,0,313,22
"site E",0,100,309,0,21,0,309,21
"site E",0,100,319,0,23,0,319,23
"site E",0,100,311,0,23,0,311,23
"site E",0,100,308,0,20,0,308,20
"site E",25,0,209,67,0,10,199,10
"site E",25,0,209,66,0,10,199,10
"site E",25,0,202,64,0,11,191,11
"site E",25,0,210,66,0,11,199,11
"site E",25,0,211,67,0,10,201,10
"site E",25,0,207,67,0,9,198,9
"site E",25,0,204,66,0,9,195,9
"site E",25,0,204,66,0,9,195,9
"site E",25,0,210,66,0,10,200,10
"site E",25,0,201,65,0,10,191,10
"site E",25,0,207,65,0,12,195,12
"site E",25,0,210,67,0,10,200,10
"site E",25,0,210,67,0,12,198,12
"site E",25,0,206,65,0,10,196,10
"site E",25,0,201,64,0,10,191,10
"site E",25,0,202,65,0,10,192,10
"site E",25,0,208,68,0,7,201,7
"site E",25,0,207,66,0,10,197,10
"site E",25,0,204,66,0,9,195,9
"site E",25,0,209,66,0,12,197,12
"site E",25,0,207,64,0,13,194,13
"site E",25,0,202,65,0,10,192,10
"site E",25,0,207,66,0,10,197,10
"site E",25,0,208,66,0,10,198,10
"site E",25,0,212,67,0,11,201,11
"site E",25,0,204,66,0,7,197,7
"site E",25,0,208,67,0,10,198,10
"site E",25,0,207,67,0,8,199,8
"site E",25,0,209,67,0,11,198,11
"site E",25,0,209,67,0,10,199,10
"site E",25,0,196,62,0,9,187,9
"site E",25,0,208,66,0,9,199,9
"site E",25,0,211,65,0,14,197,14
"site E",25,0,209,67,0,11,198,11
"site E",25,0,207,66,0,9,198,9
"site E",25,0,209,66,0,11,198,11
"site E",25,0,210,68,0,10,200,10
"site E",25,0,206,66,0,9,197,9
"site E",25,0,208,67,0,10,198,10
"site E",25,0,212,67,0,12,200,12
"site E",25,25,207,67,2,6,201,8
"site E",25,25,201,65,3,7,194,10
"site E",25,25,212,68,3,8,204,11
"site E",25,25,205,67,2,7,198,9
"site E",25,25,208,68,3,7,201,10
"site E",25,25,205,67,2,7,198,9
"site E",25,25,204,66,3,7,197,10
"site E",25,25,204,66,2,6,198,8
"site E",25,25,205,66,3,8,197,11
"site E",25,25,204,66,3,7,197,10
"site E",25,25,201,64,3,8,193,11
"site E",25,25,197,64,2,6,191,8
"site E",25,25,195,63,2,7,188,9
"site E",25,25,199,65,2,6,193,8
"site E",25,25,210,67,3,9,201,12
"site E",25,25,202,64,3,8,194,11
"site E",25,25,208,68,2,7,201,9
"site E",25,25,202,65,3,8,194,11
"site E",25,25,206,66,3,7,199,10
"site E",25,25,203,66,2,7,196,9
"site E",25,25,209,66,3,9,200,12
"site E",25,25,204,65,3,8,196,11
"site E",25,25,198,64,3,7,191,10
"site E",25,25,204,66,3,7,197,10
"site E",25,25,203,66,2,6,197,8
"site E",25,25,206,66,3,7,199,10
"site E",25,25,202,66,2,7,195,9
"site E",25,25,201,64,3,7,194,10
"site E",25,25,208,67,3,7,201,10
"site E",25,25,211,68,3,7,204,10
"site E",25,25,199,65,3,7,192,10
"site E",25,25,202,64,3,8,194,11
"site E",25,25,205,67,2,5,200,7
"site E",25,25,207,68,2,7,200,9
"site E",25,25,198,63,3,8,190,11
"site E",25,25,205,67,2,7,198,9
"site E",25,25,200,65,3,7,193,10
"site E",25,25,202,66,2,7,195,9
"site E",25,25,198,64,3,7,191,10
"site E",25,25,201,66,2,6,195,8
"site E",25,50,202,66,5,5,197,10
"site E",25,50,200,66,5,5,195,10
"site E",25,50,196,64,5,4,192,9
"site E",25,50,198,65,5,4,194,9
"site E",25,50,200,65,5,5,195,10
"site E",25,50,204,66,6,5,199,11
"site E",25,50,202,66,6,4,198,10
"site E",25,50,208,68,5,5,203,10
"site E",25,50,203,66,5,4,199,9
"site E",25,50,207,68,4,4,203,8
"site E",25,50,200,66,6,5,195,11
"site E",25,50,205,67,5,5,200,10
"site E",25,50,205,67,4,4,201,8
"site E",25,50,198,64,5,5,193,10
"site E",25,50,201,66,5,5,196,10
"site E",25,50,203,67,5,5,198,10
"site E",25,50,202,66,5,5,197,10
"site E",25,50,207,67,5,4,203,9
"site E",25,50,202,66,5,5,197,10
"site E",25,50,202,66,5,5,197,10
"site E",25,50,201,66,5,4,197,9
"site E",25,50,204,67,5,5,199,10
"site E",25,50,199,65,5,5,194,10
"site E",25,50,203,66,6,5,198,11
"site E",25,50,205,67,6,5,200,11
"site E",25,50,204,67,5,5,199,10
"site E",25,50,197,64,5,5,192,10
"site E",25,50,207,67,5,5,202,10
"site E",25,50,203,66,6,5,198,11
"site E",25,50,195,64,4,3,192,7
"site E",25,50,200,66,6,5,195,11
"site E",25,50,214,70,6,6,208,12
"site E",25,50,203,66,5,5,198,10
"site E",25,50,198,64,5,4,194,9
"site E",25,50,199,66,6,5,194,11
"site E",25,50,196,65,6,4,192,10
"site E",25,50,192,62,5,5,187,10
"site E",25,50,207,68,6,5,202,11
"site E",25,50,202,66,5,4,198,9
"site E",25,50,199,66,5,5,194,10
"site E",25,75,195,65,7,2,193,9
"site E",25,75,200,66,7,2,198,9
"site E",25,75,189,62,9,2,187,11
"site E",25,75,203,67,8,2,201,10
"site E",25,75,201,66,8,2,199,10
"site E",25,75,192,65,5,1,191,6
"site E",25,75,193,65,8,2,191,10
"site E",25,75,193,64,6,2,191,8
"site E",25,75,196,65,8,2,194,10
"site E",25,75,191,63,8,2,189,10
"site E",25,75,195,64,8,3,192,11
"site E",25,75,202,67,9,3,199,12
"site E",25,75,196,66,6,2,194,8
"site E",25,75,195,65,6,2,193,8
"site E",25,75,196,66,8,2,194,10
"site E",25,75,195,65,8,2,193,10
"site E",25,75,197,65,8,2,195,10
"site E",25,75,194,64,8,2,192,10
"site E",25,75,198,65,7,2,196,9
"site E",25,75,197,65,8,2,195,10
"site E",25,75,186,62,8,2,184,10
"site E",25,75,208,69,9,2,206,11
"site E",25,75,197,65,8,2,195,10
"site E",25,75,201,67,7,2,199,9
"site E",25,75,197,66,5,2,195,7
"site E",25,75,190,63,7,2,188,9
"site E",25,75,197,65,8,3,194,11
"site E",25,75,195,65,8,2,193,10
"site E",25,75,198,65,7,2,196,9
"site E",25,75,196,65,8,2,194,10
"site E",25,75,196,65,8,2,194,10
"site E",25,75,192,64,9,2,190,11
"site E",25,75,201,66,8,2,199,10
"site E",25,75,202,67,8,3,199,11
"site E",25,75,201,67,8,2,199,10
"site E",25,75,196,65,7,2,194,9
"site E",25,75,197,65,6,2,195,8
"site E",25,75,199,66,8,2,197,10
"site E",25,75,204,68,8,2,202,10
"site E",25,75,205,68,8,2,203,10
"site E",25,100,189,64,11,0,189,11
"site E",25,100,200,66,11,0,200,11
"site E",25,100,194,64,10,0,194,10
"site E",25,100,197,66,8,0,197,8
"site E",25,100,194,65,11,0,194,11
"site E",25,100,208,70,8,0,208,8
"site E",25,100,193,64,10,0,193,10
"site E",25,100,199,66,8,0,199,8
"site E",25,100,199,67,9,0,199,9
"site E",25,100,198,66,8,0,198,8
"site E",25,100,196,65,10,0,196,10
"site E",25,100,188,63,10,0,188,10
"site E",25,100,196,66,12,0,196,12
"site E",25,100,200,67,7,0,200,7
"site E",25,100,202,67,8,0,202,8
"site E",25,100,193,65,9,0,193,9
"site E",25,100,190,64,9,0,190,9
"site E",25,100,192,64,12,0,192,12
"site E",25,100,197,66,8,0,197,8
"site E",25,100,199,67,7,0,199,7
"site E",25,100,195,66,10,0,195,10
"site E",25,100,194,65,11,0,194,11
"site E",25,100,202,67,9,0,202,9
"site E",25,100,194,65,9,0,194,9
"site E",25,100,200,67,11,0,200,11
"site E",25,100,188,64,10,0,188,10
"site E",25,100,191,65,9,0,191,9
"site E",25,100,195,66,8,0,195,8
"site E",25,100,194,65,9,0,194,9
"site E",25,100,196,66,10,0,196,10
"site E",25,100,202,68,10,0,202,10
"site E",25,100,191,65,7,0,191,7
"site E",25,100,190,64,9,0,190,9
"site E",25,100,197,66,10,0,197,10
"site E",25,100,194,66,9,0,194,9
"site E",25,100,201,67,11,0,201,11
"site E",25,100,196,65,12,0,196,12
"site E",25,100,196,65,9,0,196,9
"site E",25,100,193,65,8,0,193,8
"site E",25,100,191,65,11,0,191,11
"site E",50,0,110,109,0,2,108,2
"site E",50,0,105,106,0,0,105,0
"site E",50,0,107,105,0,3,104,3
"site E",50,0,106,108,0,0,106,0
"site E",50,0,105,105,0,0,105,0
"site E",50,0,108,106,0,4,104,4
"site E",50,0,109,109,0,1,108,1
"site E",50,0,107,107,0,1,106,1
"site E",50,0,111,108,0,4,107,4
"site E",50,0,112,107,0,5,107,5
"site E",50,0,110,109,0,2,108,2
"site E",50,0,109,105,0,5,104,5
"site E",50,0,111,111,0,1,110,1
"site E",50,0,107,104,0,3,104,3
"site E",50,0,109,108,0,3,106,3
"site E",50,0,109,107,0,4,105,4
"site E",50,0,112,109,0,4,108,4
"site E",50,0,110,108,0,4,106,4
"site E",50,0,101,102,0,0,101,0
"site E",50,0,106,104,0,3,103,3
"site E",50,0,110,108,0,3,107,3
"site E",50,0,107,104,0,3,104,3
"site E",50,0,103,104,0,1,102,1
"site E",50,0,111,107,0,4,107,4
"site E",50,0,112,106,0,6,106,6
"site E",50,0,109,108,0,2,107,2
"site E",50,0,107,104,0,5,102,5
"site E",50,0,99,99,0,2,97,2
"site E",50,0,107,106,0,2,105,2
"site E",50,0,109,107,0,3,106,3
"site E",50,0,110,108,0,3,107,3
"site E",50,0,111,109,0,4,107,4
"site E",50,0,107,104,0,3,104,3
"site E",50,0,106,103,0,3,103,3
"site E",50,0,106,105,0,3,103,3
"site E",50,0,112,109,0,3,109,3
"site E",50,0,107,104,0,4,103,4
"site E",50,0,107,103,0,6,101,6
"site E",50,0,114,110,0,5,109,5
"site E",50,0,108,107,0,3,105,3
"site E",50,25,109,109,1,1,108,2
"site E",50,25,108,106,1,3,105,4
"site E",50,25,111,110,1,1,110,2
"site E",50,25,107,105,1,3,104,4
"site E",50,25,108,107,1,3,105,4
"site E",50,25,107,106,1,2,105,3
"site E",50,25,108,107,1,2,106,3
"site E",50,25,109,108,1,2,107,3
"site E",50,25,110,108,1,4,106,5
"site E",50,25,107,105,1,3,104,4
"site E",50,25,111,108,1,3,108,4
"site E",50,25,110,106,1,4,106,5
"site E",50,25,109,105,1,4,105,5
"site E",50,25,110,107,1,3,107,4
"site E",50,25,105,103,1,3,102,4
"site E",50,25,111,110,1,3,108,4
"site E",50,25,107,105,1,3,104,4
"site E",50,25,108,107,1,2,106,3
"site E",50,25,109,106,1,3,106,4
"site E",50,25,106,105,1,2,104,3
"site E",50,25,110,107,1,3,107,4
"site E",50,25,103,102,1,2,101,3
"site E",50,25,107,104,1,3,104,4
"site E",50,25,110,106,1,4,106,5
"site E",50,25,107,104,1,4,103,5
"site E",50,25,109,108,1,1,108,2
"site E",50,25,111,108,1,3,108,4
"site E",50,25,115,111,1,5,110,6
"site E",50,25,106,104,1,3,103,4
"site E",50,25,108,105,1,3,105,4
"site E",50,25,108,105,1,3,105,4
"site E",50,25,107,107,1,2,105,3
"site E",50,25,108,107,1,3,105,4
"site E",50,25,108,107,1,3,105,4
"site E",50,25,107,105,1,3,104,4
"site E",50,25,112,109,1,5,107,6
"site E",50,25,105,104,1,3,102,4
"site E",50,25,103,103,0,0,103,0
"site E",50,25,113,109,1,5,108,6
"site E",50,25,108,108,1,1,107,2
"site E",50,50,112,111,3,1,111,4
"site E",50,50,107,105,2,2,105,4
"site E",50,50,108,107,2,2,106,4
"site E",50,50,108,108,2,2,106,4
"site E",50,50,106,104,3,2,104,5
"site E",50,50,103,104,2,0,103,2
"site E",50,50,107,106,3,2,105,5
"site E",50,50,109,108,2,2,107,4
"site E",50,50,112,110,2,2,110,4
"site E",50,50,107,107,2,1,106,3
"site E",50,50,105,106,1,1,104,2
"site E",50,50,110,110,2,2,108,4
"site E",50,50,107,108,0,0,107,0
"site E",50,50,104,104,2,1,103,3
"site E",50,50,108,107,2,2,106,4
"site E",50,50,110,109,2,2,108,4
"site E",50,50,106,107,0,0,106,0
"site E",50,50,110,110,2,1,109,3
"site E",50,50,109,109,2,2,107,4
"site E",50,50,107,108,2,1,106,3
"site E",50,50,107,107,2,1,106,3
"site E",50,50,106,107,1,0,106,1
"site E",50,50,108,108,1,1,107,2
"site E",50,50,109,108,2,2,107,4
"site E",50,50,104,105,1,0,104,1
"site E",50,50,109,107,2,2,107,4
"site E",50,50,107,105,2,2,105,4
"site E",50,50,111,110,2,2,109,4
"site E",50,50,110,110,2,1,109,3
"site E",50,50,108,108,2,2,106,4
"site E",50,50,109,109,3,2,107,5
"site E",50,50,107,108,1,1,106,2
"site E",50,50,111,109,2,2,109,4
"site E",50,50,105,104,3,2,103,5
"site E",50,50,110,111,2,1,109,3
"site E",50,50,105,106,2,1,104,3
"site E",50,50,106,106,2,2,104,4
"site E",50,50,106,106,2,1,105,3
"site E",50,50,108,107,2,2,106,4
"site E",50,50,101,102,0,0,101,0
"site E",50,75,109,109,1,0,109,1
"site E",50,75,108,107,3,1,107,4
"site E",50,75,108,108,1,0,108,1
"site E",50,75,108,109,4,1,107,5
"site E",50,75,107,108,2,1,106,3
"site E",50,75,109,108,4,1,108,5
"site E",50,75,108,108,2,0,108,2
"site E",50,75,106,107,1,0,106,1
"site E",50,75,111,110,3,1,110,4
"site E",50,75,108,108,4,1,107,5
"site E",50,75,108,108,3,1,107,4
"site E",50,75,107,108,0,0,107,0
"site E",50,75,106,107,2,1,105,3
"site E",50,75,105,107,3,0,105,3
"site E",50,75,103,104,3,0,103,3
"site E",50,75,107,106,3,1,106,4
"site E",50,75,107,107,3,1,106,4
"site E",50,75,107,106,3,1,106,4
"site E",50,75,110,110,2,1,109,3
"site E",50,75,108,109,2,0,108,2
"site E",50,75,102,104,0,0,102,0
"site E",50,75,105,106,2,1,104,3
"site E",50,75,110,110,4,1,109,5
"site E",50,75,103,104,2,1,102,3
"site E",50,75,106,106,3,1,105,4
"site E",50,75,110,110,2,0,110,2
"site E",50,75,109,109,3,1,108,4
"site E",50,75,107,107,2,0,107,2
"site E",50,75,103,104,2,0,103,2
"site E",50,75,107,107,4,1,106,5
"site E",50,75,105,106,4,1,104,5
"site E",50,75,107,107,3,1,106,4
"site E",50,75,106,106,3,1,105,4
"site E",50,75,105,106,1,0,105,1
"site E",50,75,105,105,3,1,104,4
"site E",50,75,107,107,2,1,106,3
"site E",50,75,107,107,3,1,106,4
"site E",50,75,104,105,2,0,104,2
"site E",50,75,114,113,3,1,113,4
"site E",50,75,108,107,2,1,107,3
"site E",50,100,108,109,3,0,108,3
"site E",50,100,106,106,4,0,106,4
"site E",50,100,105,106,3,0,105,3
"site E",50,100,106,106,4,0,106,4
"site E",50,100,105,105,3,0,105,3
"site E",50,100,109,110,5,0,109,5
"site E",50,100,105,107,2,0,105,2
"site E",50,100,108,109,2,0,108,2
"site E",50,100,105,105,2,0,105,2
"site E",50,100,107,109,3,0,107,3
"site E",50,100,105,107,3,0,105,3
"site E",50,100,108,109,3,0,108,3
"site E",50,100,102,103,5,0,102,5
"site E",50,100,104,105,3,0,104,3
"site E",50,100,105,107,3,0,105,3
"site E",50,100,103,104,4,0,103,4
"site E",50,100,104,106,1,0,104,1
"site E",50,100,105,107,3,0,105,3
"site E",50,100,106,107,4,0,106,4
"site E",50,100,107,107,4,0,107,4
"site E",50,100,108,110,0,0,108,0
"site E",50,100,104,106,4,0,104,4
"site E",50,100,101,103,2,0,101,2
"site E",50,100,106,108,3,0,106,3
"site E",50,100,105,106,4,0,105,4
"site E",50,100,106,106,5,0,106,5
"site E",50,100,104,106,1,0,104,1
"site E",50,100,106,107,2,0,106,2
"site E",50,100,109,110,4,0,109,4
"site E",50,100,104,105,2,0,104,2
"site E",50,100,105,106,0,0,105,0
"site E",50,100,105,106,2,0,105,2
"site E",50,100,106,107,1,0,106,1
"site E",50,100,103,104,3,0,103,3
"site E",50,100,105,106,2,0,105,2
"site E",50,100,106,107,1,0,106,1
"site E",50,100,108,108,4,0,108,4
"site E",50,100,108,109,3,0,108,3
"site E",50,100,103,105,2,0,103,2
"site E",50,100,105,106,4,0,105,4
"site E",75,0,40,124,0,0,40,0
"site E",75,0,41,122,0,0,41,0
"site E",75,0,39,120,0,0,39,0
"site E",75,0,41,125,0,0,41,0
"site E",75,0,40,121,0,0,40,0
"site E",75,0,39,119,0,0,39,0
"site E",75,0,41,125,0,0,41,0
"site E",75,0,41,122,0,0,41,0
"site E",75,0,41,126,0,0,41,0
"site E",75,0,44,131,0,1,43,1
"site E",75,0,41,121,0,1,40,1
"site E",75,0,40,121,0,0,40,0
"site E",75,0,40,121,0,1,39,1
"site E",75,0,39,120,0,0,39,0
"site E",75,0,41,124,0,0,41,0
"site E",75,0,41,121,0,0,41,0
"site E",75,0,41,125,0,0,41,0
"site E",75,0,41,124,0,0,41,0
"site E",75,0,41,121,0,0,41,0
"site E",75,0,41,121,0,0,41,0
"site E",75,0,42,124,0,0,42,0
"site E",75,0,40,120,0,0,40,0
"site E",75,0,40,122,0,0,40,0
"site E",75,0,39,121,0,0,39,0
"site E",75,0,42,125,0,0,42,0
"site E",75,0,40,121,0,0,40,0
"site E",75,0,41,123,0,0,41,0
"site E",75,0,40,124,0,0,40,0
"site E",75,0,41,121,0,0,41,0
"site E",75,0,40,123,0,0,40,0
"site E",75,0,41,122,0,0,41,0
"site E",75,0,41,124,0,0,41,0
"site E",75,0,41,122,0,0,41,0
"site E",75,0,39,121,0,0,39,0
"site E",75,0,41,121,0,0,41,0
"site E",75,0,40,123,0,0,40,0
"site E",75,0,42,129,0,0,42,0
"site E",75,0,41,125,0,0,41,0
"site E",75,0,42,124,0,0,42,0
"site E",75,0,41,126,0,0,41,0
"site E",75,25,42,126,0,0,42,0
"site E",75,25,41,124,0,0,41,0
"site E",75,25,40,124,0,0,40,0
"site E",75,25,38,118,0,0,38,0
"site E",75,25,40,122,0,0,40,0
"site E",75,25,42,128,0,0,42,0
"site E",75,25,42,126,0,0,42,0
"site E",75,25,40,121,0,0,40,0
"site E",75,25,41,123,0,0,41,0
"site E",75,25,40,123,0,0,40,0
"site E",75,25,39,120,0,0,39,0
"site E",75,25,40,124,0,0,40,0
"site E",75,25,42,126,0,0,42,0
"site E",75,25,39,119,0,0,39,0
"site E",75,25,42,127,0,0,42,0
"site E",75,25,41,124,0,0,41,0
"site E",75,25,41,125,0,0,41,0
"site E",75,25,42,124,0,0,42,0
"site E",75,25,41,126,0,0,41,0
"site E",75,25,40,122,0,0,40,0
"site E",75,25,41,124,0,0,41,0
"site E",75,25,41,123,0,0,41,0
"site E",75,25,39,120,0,0,39,0
"site E",75,25,42,126,0,0,42,0
"site E",75,25,40,122,0,0,40,0
"site E",75,25,39,119,0,0,39,0
"site E",75,25,40,118,0,1,39,1
"site E",75,25,42,124,0,0,42,0
"site E",75,25,42,126,0,0,42,0
"site E",75,25,41,119,0,1,40,1
"site E",75,25,40,122,0,0,40,0
"site E",75,25,39,117,0,0,39,0
"site E",75,25,41,125,0,0,41,0
"site E",75,25,42,128,0,0,42,0
"site E",75,25,40,120,0,0,40,0
"site E",75,25,42,125,0,0,42,0
"site E",75,25,41,121,0,0,41,0
"site E",75,25,40,120,0,0,40,0
"site E",75,25,41,126,0,0,41,0
"site E",75,25,42,125,0,0,42,0
"site E",75,50,42,125,0,0,42,0
"site E",75,50,40,123,0,0,40,0
"site E",75,50,41,124,0,0,41,0
"site E",75,50,41,121,0,0,41,0
"site E",75,50,41,124,0,0,41,0
"site E",75,50,41,124,0,0,41,0
"site E",75,50,40,124,0,0,40,0
"site E",75,50,42,126,0,0,42,0
"site E",75,50,41,124,0,0,41,0
"site E",75,50,38,118,0,0,38,0
"site E",75,50,41,127,0,0,41,0
"site E",75,50,40,121,1,0,40,1
"site E",75,50,41,124,1,0,41,1
"site E",75,50,40,122,0,0,40,0
"site E",75,50,39,120,1,0,39,1
"site E",75,50,40,118,0,0,40,0
"site E",75,50,41,122,0,0,41,0
"site E",75,50,41,126,0,0,41,0
"site E",75,50,41,125,0,0,41,0
"site E",75,50,42,128,0,0,42,0
"site E",75,50,41,123,0,0,41,0
"site E",75,50,40,123,0,0,40,0
"site E",75,50,41,124,0,0,41,0
"site E",75,50,42,126,0,0,42,0
"site E",75,50,42,126,0,0,42,0
"site E",75,50,41,121,0,0,41,0
"site E",75,50,41,124,0,0,41,0
"site E",75,50,41,123,0,0,41,0
"site E",75,50,40,123,0,0,40,0
"site E",75,50,40,122,0,0,40,0
"site E",75,50,41,121,0,0,41,0
"site E",75,50,40,123,1,0,40,1
"site E",75,50,40,122,0,0,40,0
"site E",75,50,42,125,0,0,42,0
"site E",75,50,39,120,0,0,39,0
"site E",75,50,41,123,0,0,41,0
"site E",75,50,38,117,0,0,38,0
"site E",75,50,40,122,0,0,40,0
"site E",75,50,40,123,0,0,40,0
"site E",75,50,40,120,0,0,40,0
"site E",75,75,39,117,0,0,39,0
"site E",75,75,39,121,0,0,39,0
"site E",75,75,40,123,0,0,40,0
"site E",75,75,40,121,0,0,40,0
"site E",75,75,42,128,0,0,42,0
"site E",75,75,40,122,1,0,40,1
"site E",75,75,40,124,0,0,40,0
"site E",75,75,41,125,0,0,41,0
"site E",75,75,42,129,0,0,42,0
"site E",75,75,39,116,0,0,39,0
"site E",75,75,42,126,0,0,42,0
"site E",75,75,40,123,1,0,40,1
"site E",75,75,43,131,1,0,43,1
"site E",75,75,42,124,0,0,42,0
"site E",75,75,41,123,0,0,41,0
"site E",75,75,41,124,0,0,41,0
"site E",75,75,40,120,0,0,40,0
"site E",75,75,39,120,0,0,39,0
"site E",75,75,40,121,0,0,40,0
"site E",75,75,41,122,0,0,41,0
"site E",75,75,39,119,0,0,39,0
"site E",75,75,43,129,1,0,43,1
"site E",75,75,40,120,0,0,40,0
"site E",75,75,41,121,0,0,41,0
"site E",75,75,41,123,0,0,41,0
"site E",75,75,42,127,0,0,42,0
"site E",75,75,41,122,0,0,41,0
"site E",75,75,41,123,0,0,41,0
"site E",75,75,41,123,0,0,41,0
"site E",75,75,42,125,0,0,42,0
"site E",75,75,41,123,0,0,41,0
"site E",75,75,41,124,0,0,41,0
"site E",75,75,40,123,0,0,40,0
"site E",75,75,41,126,0,0,41,0
"site E",75,75,41,124,0,0,41,0
"site E",75,75,42,128,0,0,42,0
"site E",75,75,42,128,0,0,42,0
"site E",75,75,41,123,0,0,41,0
"site E",75,75,40,120,0,0,40,0
"site E",75,75,42,126,0,0,42,0
"site E",75,100,40,122,0,0,40,0
"site E",75,100,42,126,0,0,42,0
"site E",75,100,41,124,0,0,41,0
"site E",75,100,42,127,1,0,42,1
"site E",75,100,40,119,0,0,40,0
"site E",75,100,41,122,0,0,41,0
"site E",75,100,40,121,0,0,40,0
"site E",75,100,40,119,0,0,40,0
"site E",75,100,39,116,0,0,39,0
"site E",75,100,39,119,0,0,39,0
"site E",75,100,41,123,0,0,41,0
"site E",75,100,39,117,0,0,39,0
"site E",75,100,40,123,0,0,40,0
"site E",75,100,41,123,0,0,41,0
"site E",75,100,41,124,0,0,41,0
"site E",75,100,43,129,0,0,43,0
"site E",75,100,40,121,0,0,40,0
"site E",75,100,42,126,0,0,42,0
"site E",75,100,41,124,0,0,41,0
"site E",75,100,42,125,0,0,42,0
"site E",75,100,40,122,0,0,40,0
"site E",75,100,42,125,0,0,42,0
"site E",75,100,40,121,0,0,40,0
"site E",75,100,40,122,0,0,40,0
"site E",75,100,39,118,0,0,39,0
"site E",75,100,41,123,0,0,41,0
"site E",75,100,43,128,0,0,43,0
"site E",75,100,40,119,1,0,40,1
"site E",75,100,40,121,0,0,40,0
"site E",75,100,40,121,0,0,40,0
"site E",75,100,43,129,0,0,43,0
"site E",75,100,43,129,0,0,43,0
"site E",75,100,43,128,0,0,43,0
"site E",75,100,40,122,1,0,40,1
"site E",75,100,41,125,0,0,41,0
"site E",75,100,41,121,0,0,41,0
"site E",75,100,40,120,0,0,40,0
"site E",75,100,41,124,0,0,41,0
"site E",75,100,40,122,0,0,40,0
"site E",75,100,39,121,0,0,39,0
"site E",100,0,0,133,0,0,0,0
"site E",100,0,0,137,0,0,0,0
"site E",100,0,0,135,0,0,0,0
"site E",100,0,0,134,0,0,0,0
"site E",100,0,0,135,0,0,0,0
"site E",100,0,0,135,0,0,0,0
"site E",100,0,1,133,0,1,0,1
"site E",100,0,0,136,0,0,0,0
"site E",100,0,0,138,0,0,0,0
"site E",100,0,0,135,0,0,0,0
"site E",100,0,0,134,0,0,0,0
"site E",100,0,0,133,0,0,0,0
"site E",100,0,0,135,0,0,0,0
"site E",100,0,0,135,0,0,0,0
"site E",100,0,0,132,0,0,0,0
"site E",100,0,1,134,0,1,0,1
"site E",100,0,0,135,0,0,0,0
"site E",100,0,0,137,0,0,0,0
"site E",100,0,0,136,0,0,0,0
"site E",100,0,0,134,0,0,0,0
"site E",100,0,0,135,0,0,0,0
"site E",100,0,0,134,0,0,0,0
"site E",100,0,0,136,0,0,0,0
"site E",100,0,0,135,0,0,0,0
"site E",100,0,0,135,0,0,0,0
"site E",100,0,0,134,0,0,0,0
"site E",100,0,0,134,0,0,0,0
"site E",100,0,0,134,0,0,0,0
"site E",100,0,0,134,0,0,0,0
"site E",100,0,0,136,0,0,0,0
"site E",100,0,0,136,0,0,0,0
"site E",100,0,0,136,0,0,0,0
"site E",100,0,0,135,0,0,0,0
"site E",100,0,0,136,0,0,0,0
"site E",100,0,0,135,0,0,0,0
"site E",100,0,0,134,0,0,0,0
"site E",100,0,0,135,0,0,0,0
"site E",100,0,0,136,0,0,0,0
"site E",100,0,0,135,0,0,0,0
"site E",100,0,0,135,0,0,0,0
"site E",100,25,0,135,0,0,0,0
"site E",100,25,0,133,0,0,0,0
"site E",100,25,0,134,0,0,0,0
"site E",100,25,0,134,0,0,0,0
"site E",100,25,1,135,0,1,0,1
"site E",100,25,0,134,0,0,0,0
"site E",100,25,0,134,0,0,0,0
"site E",100,25,0,135,0,0,0,0
"site E",100,25,0,135,0,0,0,0
"site E",100,25,1,136,0,1,0,1
"site E",100,25,0,134,0,0,0,0
"site E",100,25,0,137,0,0,0,0
"site E",100,25,1,132,0,1,0,1
"site E",100,25,0,135,0,0,0,0
"site E",100,25,0,133,0,0,0,0
"site E",100,25,0,135,0,0,0,0
"site E",100,25,0,136,0,0,0,0
"site E",100,25,0,135,0,0,0,0
"site E",100,25,0,135,0,0,0,0
"site E",100,25,0,134,0,0,0,0
"site E",100,25,0,132,0,0,0,0
"site E",100,25,1,134,0,1,0,1
"site E",100,25,0,135,0,0,0,0
"site E",100,25,0,136,0,0,0,0
"site E",100,25,0,132,0,0,0,0
"site E",100,25,0,134,0,0,0,0
"site E",100,25,0,135,0,0,0,0
"site E",100,25,0,135,0,0,0,0
"site E",100,25,0,136,0,0,0,0
"site E",100,25,0,136,0,0,0,0
"site E",100,25,1,134,0,1,0,1
"site E",100,25,0,133,0,0,0,0
"site E",100,25,0,135,0,0,0,0
"site E",100,25,0,136,0,0,0,0
"site E",100,25,0,133,0,0,0,0
"site E",100,25,0,136,0,0,0,0
"site E",100,25,0,135,0,0,0,0
"site E",100,25,0,134,0,0,0,0
"site E",100,25,0,134,0,0,0,0
"site E",100,25,0,137,0,0,0,0
"site E",100,50,0,136,0,0,0,0
"site E",100,50,0,135,0,0,0,0
"site E",100,50,0,135,0,0,0,0
"site E",100,50,0,136,0,0,0,0
"site E",100,50,0,136,0,0,0,0
"site E",100,50,0,136,0,0,0,0
"site E",100,50,0,134,1,0,0,1
"site E",100,50,0,134,0,0,0,0
"site E",100,50,0,136,0,0,0,0
"site E",100,50,0,135,0,0,0,0
"site E",100,50,0,134,0,0,0,0
"site E",100,50,0,135,0,0,0,0
"site E",100,50,0,137,0,0,0,0
"site E",100,50,0,135,1,0,0,1
"site E",100,50,0,135,1,0,0,1
"site E",100,50,0,136,0,0,0,0
"site E",100,50,0,135,0,0,0,0
"site E",100,50,0,134,1,0,0,1
"site E",100,50,0,135,0,0,0,0
"site E",100,50,0,134,0,0,0,0
"site E",100,50,0,135,0,0,0,0
"site E",100,50,0,134,0,0,0,0
"site E",100,50,0,134,0,0,0,0
"site E",100,50,0,134,1,0,0,1
"site E",100,50,0,133,0,0,0,0
"site E",100,50,0,138,0,0,0,0
"site E",100,50,0,135,0,0,0,0
"site E",100,50,0,134,0,0,0,0
"site E",100,50,0,135,0,0,0,0
"site E",100,50,0,134,0,0,0,0
"site E",100,50,0,135,1,0,0,1
"site E",100,50,0,135,0,0,0,0
"site E",100,50,0,134,0,0,0,0
"site E",100,50,0,134,0,0,0,0
"site E",100,50,0,134,0,0,0,0
"site E",100,50,0,134,0,0,0,0
"site E",100,50,0,137,0,0,0,0
"site E",100,50,0,136,0,0,0,0
"site E",100,50,0,136,0,0,0,0
"site E",100,50,0,136,0,0,0,0
"site E",100,75,0,137,1,0,0,1
"site E",100,75,0,135,0,0,0,0
"site E",100,75,0,132,0,0,0,0
"site E",100,75,0,136,0,0,0,0
"site E",100,75,0,136,0,0,0,0
"site E",100,75,0,134,0,0,0,0
"site E",100,75,0,134,0,0,0,0
"site E",100,75,0,135,0,0,0,0
"site E",100,75,0,134,0,0,0,0
"site E",100,75,0,137,0,0,0,0
"site E",100,75,0,135,0,0,0,0
"site E",100,75,0,135,0,0,0,0
"site E",100,75,0,135,0,0,0,0
"site E",100,75,0,132,0,0,0,0
"site E",100,75,0,137,0,0,0,0
"site E",100,75,0,136,0,0,0,0
"site E",100,75,0,135,0,0,0,0
"site E",100,75,0,134,0,0,0,0
"site E",100,75,0,135,1,0,0,1
"site E",100,75,0,133,0,0,0,0
"site E",100,75,0,134,1,0,0,1
"site E",100,75,0,136,0,0,0,0
"site E",100,75,0,134,0,0,0,0
"site E",100,75,0,135,0,0,0,0
"site E",100,75,0,134,0,0,0,0
"site E",100,75,0,137,0,0,0,0
"site E",100,75,0,135,0,0,0,0
"site E",100,75,0,134,0,0,0,0
"site E",100,75,0,137,0,0,0,0
"site E",100,75,0,138,0,0,0,0
"site E",100,75,0,135,0,0,0,0
"site E",100,75,0,133,0,0,0,0
"site E",100,75,0,134,0,0,0,0
"site E",100,75,0,135,0,0,0,0
"site E",100,75,0,135,0,0,0,0
"site E",100,75,0,138,0,0,0,0
"site E",100,75,0,137,0,0,0,0
"site E",100,75,0,135,1,0,0,1
"site E",100,75,0,134,0,0,0,0
"site E",100,75,0,137,0,0,0,0
"site E",100,100,0,132,0,0,0,0
"site E",100,100,0,135,0,0,0,0
"site E",100,100,0,136,0,0,0,0
"site E",100,100,0,134,0,0,0,0
"site E",100,100,0,135,0,0,0,0
"site E",100,100,0,135,0,0,0,0
"site E",100,100,0,135,0,0,0,0
"site E",100,100,0,135,0,0,0,0
"site E",100,100,0,135,0,0,0,0
"site E",100,100,0,137,0,0,0,0
"site E",100,100,0,135,0,0,0,0
"site E",100,100,0,133,1,0,0,1
"site E",100,100,0,134,0,0,0,0
"site E",100,100,0,135,0,0,0,0
"site E",100,100,0,137,0,0,0,0
"site E",100,100,0,136,0,0,0,0
"site E",100,100,0,134,0,0,0,0
"site E",100,100,0,136,1,0,0,1
"site E",100,100,0,136,0,0,0,0
"site E",100,100,0,134,1,0,0,1
"site E",100,100,0,136,0,0,0,0
"site E",100,100,0,134,0,0,0,0
"site E",100,100,0,134,0,0,0,0
"site E",100,100,0,134,0,0,0,0
"site E",100,100,0,134,0,0,0,0
"site E",100,100,0,136,0,0,0,0
"site E",100,100,0,136,0,0,0,0
"site E",100,100,0,135,0,0,0,0
"site E",100,100,0,133,0,0,0,0
"site E",100,100,0,135,0,0,0,0
"site E",100,100,0,134,0,0,0,0
"site E",100,100,0,134,0,0,0,0
"site E",100,100,0,133,0,0,0,0
"site E",100,100,0,134,0,0,0,0
"site E",100,100,0,134,0,0,0,0
"site E",100,100,0,136,0,0,0,0
"site E",100,100,0,135,0,0,0,0
"site E",100,100,0,134,0,0,0,0
"site E",100,100,0,136,0,0,0,0
"site E",100,100,0,132,0,0,0,0
